酷安|com.coolapk.market
微信|com.tencent.mm
网易云音乐|com.netease.cloudmusic
QQ|com.tencent.mobileqq
RE管理器:Root Explorer|com.speedsoftware.rootexplorer
手机淘宝|com.taobao.taobao
哔哩哔哩|tv.danmaku.bili
新浪微博|com.sina.weibo
支付宝|com.eg.android.AlipayGphone
WiFi万能钥匙|com.snda.wifilocating
百度网盘|com.baidu.netdisk
Greenify绿色守护|com.oasisfeng.greenify
高德地图|com.autonavi.minimap
WPS Office|cn.wps.moffice_eng
知乎|com.zhihu.android
京东|com.jingdong.app.mall
一个木函|com.One.WoodenLetter
中国建设银行|com.chinamworld.main
百度地图|com.baidu.BaiduMap
Via浏览器|mark.via
ES文件浏览器|com.estrongs.android.pop
优酷视频|com.youku.phone
UC浏览器|com.UCMobile
美团-团购美食电影酒店优惠|com.sankuai.meituan
阿里星球:TTPod Android|com.sds.android.ttpod
快图浏览|com.alensw.PicFolder
百度贴吧|com.baidu.tieba
SuperSU权限管理|eu.chainfire.supersu
Xposed框架|de.robv.android.xposed.installer
腾讯视频|com.tencent.qqlive
讯飞输入法|com.iflytek.inputmethod
搜狗输入法|com.sohu.inputmethod.sogou
百度输入法|com.baidu.input
滴滴出行|com.sdu.didi.psnger
黑阈|me.piebridge.brevent
迅雷|com.xunlei.downloadprovider
QQ音乐|com.tencent.qqmusic
LBE安全大师(免ROOT)|com.lbe.security
夸克|com.quark.browser
酷狗音乐|com.kugou.android
爱奇艺|com.qiyi.video
联通手机营业厅(官方版)|com.sinovatech.unicom.ui
布卡漫画|cn.ibuka.manga.ui
闲鱼|com.taobao.idlefish
斗鱼直播|air.tv.douyu.android
QQ同步助手 换机必备通讯录软件照片一键安全备份|com.tencent.qqpim
静读天下:Moon+ Reader Pro|com.flyersoft.moonreaderp
饿了么|me.ele
墨迹天气|com.moji.mjweather
网易新闻（官方）|com.netease.newsreader.activity
抖音短视频|com.ss.android.ugc.aweme
Share微博客户端|com.hengye.share
QQ浏览器-腾讯王卡，全网免流量|com.tencent.mtt
多看阅读|com.duokan.reader
网易有道词典-英语学习翻译|com.youdao.dict
今日头条|com.ss.android.article.news
印象笔记|com.evernote
虾米音乐|fm.xiami.main
QQ邮箱|com.tencent.androidqqmail
暴风影音视频播放器|com.storm.smart
KingRoot-一键权限获取，授权管理|com.kingroot.kinguser
Adobe Flash Player|com.adobe.flashplayer
大众点评|com.dianping.v1
猎豹清理大师国际版:Clean Master|com.cleanmaster.mguard
PDF阅读器 Adobe reader|com.adobe.reader
YY|com.duowan.mobile
QQ阅读-小说漫画电子书阅读器|com.qq.reader
中国工商银行|com.icbc
阅读|com.gedoor.monkeybook
冰箱 Ice Box|com.catchingnow.icebox
美图秀秀|com.mt.mtxx.mtxx
扫描全能王|com.intsig.camscanner
MOMO陌陌|com.immomo.momo
安兔兔评测|com.antutu.ABenchMark
Adobe AIR for Android|com.adobe.air
快手|com.smile.gifmaker
爱奇艺PPS|tv.pps.mobile
X浏览器|com.mmbox.xbrowser
什么值得买|com.smzdm.client.android
Pure 轻雨 图标包|me.morirain.dev.iconpack.pure
即刻|com.ruguoapp.jike
存储空间清理|com.ktls.fileinfo
Pure天气|hanjie.app.pureweather
BeautyCam美颜相机|com.meitu.meiyancamera
QQ安全中心|com.tencent.token
掌上英雄联盟|com.tencent.qt.qtl
天猫|com.tmall.wireless
QQ国际版|com.tencent.mobileqqi
TIM-QQ办公简洁版|com.tencent.tim
影音先锋|com.xfplay.play
看点|com.qihoo360.daily
蜻蜓FM-听书|fm.qingting.qtradio
12306智行火车票|com.yipiao
QQ HD|com.tencent.minihd.qq
豆瓣|com.douban.frodo
携程旅行迪士尼酒店机票火车票旅游门票攻略团购|ctrip.android.view
爱字体|com.kapp.ifont
熊猫直播|com.panda.videoliveplatform
美团外卖-美食水果优惠订餐|com.sankuai.meituan.takeoutnew
PP视频（原PPTV聚力视频）|com.pplive.androidphone
VC浏览器|com.funnylemon.browser
摩拜单车|com.mobike.mobikeapp
汽车之家|com.cubic.autohome
乐视视频|com.letv.android.client
QQ空间|com.qzone
微博国际版|com.weico.international
索尼音乐|com.sonyericsson.music
铁路12306|com.MobileTicket
字体管家（一键更换字体）|com.xinmei365.font
小米商城|com.xiaomi.shop
米家|com.xiaomi.smarthome
AcFun|tv.acfundanmaku.video
MT管理器2.0|bin.mt.plus
小米运动|com.xiaomi.hm.health
Sorcery 图标|com.sorcerer.sorcery.iconpack
虎牙直播|com.duowan.kiwi
相机360|vStudio.Android.Camera360
追书神器|com.ushaqi.zhuishushenqi
搜狐视频-电影电视剧美剧影音视频播放器|com.sohu.sohuvideo
喜马拉雅-听有声小说新闻音乐相声|com.ximalaya.ting.android
IT之家|com.ruanmei.ithome
安卓壁纸-含动态壁纸|com.androidesk
猎豹清理大师|com.cleanmaster.mguard_cn
酷我音乐播放器|cn.kuwo.player
共享单车|so.ofo.labofo
亚马逊|cn.amazon.mShop.android
京东金融|com.jd.jrapp
随手记理财记账|com.mymoney
WiFi万能钥匙国际版|com.halo.wifikey.wifilocating
中国移动|com.greenpoint.android.mc10086.activity
星空视频壁纸|yyc.xk
360安全桌面（手机版）|com.qihoo360.launcher
360卫士极客版|com.qihoo.antivirus
招商银行|cmb.pb
去哪儿旅行-酒店.火车|com.Qunar
微软桌面|com.microsoft.launcher
同花顺手机炒股股票软件|com.hexin.plat.android
Keep|com.gotokeep.keep
全民K歌|com.tencent.karaoke
腾讯新闻-事实派，真实客观的精品资讯|com.tencent.news
QQ轻聊版|com.tencent.qqlite
糗事百科|qsbk.app
凤凰新闻|com.ifeng.news2
下厨房|com.xiachufang
Microsoft Word|com.microsoft.office.word
快牙|com.dewmobile.kuaiya
镧·系统工具箱|com.xzr.La.systemtoolbox
58同城 -租房招聘兼职二手车|com.wuba
腾讯手机管家—微信清理|com.tencent.qqpimsecure
爱壁纸_桌面锁屏|com.lovebizhi.wallpaper
MT管理器|bin.mt
ZAKER（新闻阅读）|com.myzaker.ZAKER_Phone
GO桌面(锁屏主题美化壁纸)|com.gau.go.launcherex
飞猪|com.taobao.trip
钉钉|com.alibaba.android.rimet
我查查|com.wochacha
千千音乐|com.ting.mp3.android
百词斩|com.jiongji.andriod.card
金山手机毒霸|com.ijinshan.duba
电信营业厅|com.ct.client
腾讯地图—发现附近吃喝玩乐|com.tencent.map
相册|com.sonyericsson.album
快看影视|com.elinkway.infinitemovies
微云|com.qq.qcloud
百度视频|com.baidu.video
万能遥控|com.duokan.phone.remotecontroller
太极|me.weishu.exp
TrackID曲目识别|com.sonyericsson.trackid
火狐浏览器|org.mozilla.firefox
千变动态头像|com.qianbian.touxiang
金山词霸|com.kingsoft
苏宁易购|com.suning.mobile.ebuy
拼多多|com.xunmeng.pinduoduo
驾考宝典-驾照考试驾校理论|com.handsgo.jiakao.android
Microsoft Excel|com.microsoft.office.excel
百度糯米|com.nuomi
土豆视频|com.tudou.android
Pixlr - 照片处理|com.pixlr.express
百度|com.baidu.searchbox
Microsoft PowerPoint|com.microsoft.office.powerpoint
115|com.ylmf.androidclient
旺信-阿里旺旺手机版|com.alibaba.mobileim
应用宝|com.tencent.android.qqdownloader
PicsArt|com.picsart.studio
网易公开课|com.netease.vopen
小猿搜题|com.fenbi.android.solar
探探|com.p1.mobile.putong
LINE camera|jp.naver.linecamera.android
搜图神器|com.example.administrator.searchpicturetool
FV悬浮球-fooView|com.fooview.android.fooview
360超级ROOT|com.qihoo.permmgr
招商银行掌上生活|com.cmbchina.ccd.pluto.cmbActivity
HTC相机:HTC Camera|com.htc.camera
AirDroid|com.sand.airdroid
天气通|sina.mobile.tianqitong
Anyview阅读器|com.anyview
中国银行手机银行|com.chinamworld.bocmbci
菜鸟裹裹|com.cainiao.wireless
触宝电话|com.cootek.smartdialer
唱吧-你的手机KTV|com.changba
懒人听书FM-电台小说收音机|bubei.tingshu
Power Clean|com.lionmobi.powerclean
魔秀桌面|com.moxiu.launcher
360手机卫士|com.qihoo360.mobilesafe
微痕迹|com.pleasure.trace_wechat
转转|com.wuba.zhuanzhuan
小米计算器|com.miui.calculator
NFC卡模拟|com.yuanwofei.cardemulator
360云盘|com.qihoo.yunpan
Weico新浪微博客户端|com.eico.weico
白描-文字识别翻译与扫描|com.uzero.baimiao
极品时刻表|com.bjjpsk.jpskb
QQ输入法|com.tencent.qqpinyin
车来了-实时掌上公交|com.ygkj.chelaile.standard
有道云笔记|com.youdao.note
魔漫相机|com.manboker.headportrait
作业帮-学生搜题利器|com.baidu.homework
网易邮箱大师|com.netease.mail
OneNote|com.microsoft.office.onenote
名片全能王|com.intsig.BizCardReader
Forest 专注森林|cc.forestapp
云闪付|com.unionpay
欧路词典|com.eusoft.eudic
温控拜拜|com.an.killthermal
易信|im.yixin
知乎日报|com.zhihu.daily.android
安兔兔评测3D|com.antutu.benchmark.full
芒果TV|com.hunantv.imgo.activity
Meeye 图标|com.yeyebbc.meeye.iconpack
猫眼|com.sankuai.movie
Faceu激萌|com.lemon.faceu
Blued|com.soft.blued
高德导航（林志玲版1.0）|com.autonavi.xmgd.navigator
语音导出|com.playwfd.wxvexporter
Steam|com.valvesoftware.android.steam.community
铃声多多|com.shoujiduoduo.ringtone
正点闹钟|com.zdworks.android.zdclock
NGA玩家社区|gov.pianzong.androidnga
农行掌上银行|com.android.bankabc
B612咔叽|com.campmobile.snowcamera
三星健康|com.sec.android.app.shealth
搜书大师|com.flyersoft.seekbooks
淘票票|com.taobao.movie.android
咪咕灵犀|com.iflytek.cmcc
贴吧极速版|com.baidu.tieba_mini
Bmap 地图|me.gfuil.bmap
触宝输入法|com.cootek.smartinputv5
大智慧|com.android.dazhihui
饿了么星选|com.baidu.lbs.waimai
substratum主题管理|projekt.substratum
360省电王|com.qihoo360.mobilesafe.opti.powerctl
豆瓣FM|com.douban.radio
360影视大全|com.qihoo.video
LBE平行空间|com.lbe.parallel
OneDrive|com.microsoft.skydrive
空调狗AirFrozen|me.yourbay.airfrozen
Opera迷你浏览器 Opera Mini 7|com.opera.mini.android
看看视频|com.xunlei.kankan
My Android Tools|cn.wq.myandroidtools
迷你UC:UC Browser Mini|com.uc.browser.en
微信读书|com.tencent.weread
开眼|com.wandoujia.eyepetizer
顺丰速运|com.sf.activity
Outlook|com.microsoft.office.outlook
手心输入法|com.xinshuru.inputmethod
镧·系统工具箱 2.0|xzr.La.systemtoolbox
唯品会|com.achievo.vipshop
百度输入法小米版|com.baidu.input_mi
Lidow|com.baiwang.PhotoFeeling
亚马逊Kindle|com.amazon.kindle
Dir|kh.android.dir
挖财记账|com.wacai365
魔力视频|com.molitv.android
CPU-Z|com.cpuid.cpu_z
八戒助手|com.dahuo.sunflower.assistant
智联招聘|com.zhaopin.social
千牛|com.taobao.qianniu
Opera|com.opera.browser
肯德基|com.yek.android.kfc.activitys
遥控精灵|com.tiqiaa.icontrol
央视影音|cn.cntv
多米音乐|com.duomi.android
一加社区|com.oneplus.bbs
交管12123|com.tmri.app.main
小咖秀|com.yixia.xiaokaxiu
纯纯写作 - 绝不丢失文本编辑器|com.drakeet.purewriter
GO输入法|com.jb.gokeyboard
WiFi连接管理器|com.roamingsoft.manager
亚马逊Kindle阅读|com.amazon.kindlefc
MIUI论坛|com.miui.miuibbs
腾讯动漫|com.qq.ac.android
有道翻译官|com.youdao.translator
阿里巴巴|com.alibaba.wireless
中信银行|com.ecitic.bank.mobile
百度文库|com.baidu.wenku
轻松天气|mobi.infolife.ezweather
涂画Sketch|com.sonymobile.sketch
航旅纵横|com.umetrip.android.msky.app
百度翻译（语音翻译）|com.baidu.baidutranslate
网易云课堂|com.netease.edu.study
傲游5浏览器|com.mx.browser
小米路由器  MiWiFi|com.xiaomi.router
鲁大师安卓版|com.ludashi.benchmark
电视家直播|com.elinkway.tvlive2
8684公交|cn.chinabus.main
QQ通讯录|com.tencent.qqphonebook
小米视频|com.miui.video
VIVA畅读|viva.reader
中华万年历国际版:ECalendar|cn.etouch.ecalendar2
Lawnchair启动器-魔趣定制版|org.mokee.lawnchair
马蜂窝旅游|com.mfw.roadbook
华为音乐播放器|com.android.mediacenter
网易严选|com.netease.yanxuan
天天P图|com.tencent.ttpic
几何天气 - Geometric Weather|wangdaye.com.geometricweather
当当|com.dangdang.buy2
浦发手机银行|cn.com.spdb.mobilebank.per
百度手机卫士|cn.opda.a.phonoalbumshoushou
爱上Radio|InternetRadio.all
小红书|com.xingin.xhs
全能相机|com.ucamera.ucam
一淘—淘宝官方返利、优惠券、比价客户端|com.taobao.etao
追追漫画|com.mandongkeji.comiclover
魔图|cn.jingling.motu.photowonder
腾讯体育-NBA中超英超直播|com.tencent.qqsports
LOFTER|com.lofter.android
Soul|cn.soulapp.android
美人相机|my.beautyCamera
PS Touch|air.com.adobe.pstouchphone
悬浮菜单 - 全面屏手势|com.ksxkq.floating
广东移动手机营业厅|com.kingpoint.gmcchh
起点读书|com.qidian.QDReader
翼支付|com.chinatelecom.bestpayclient
中关村在线|com.zol.android
网络信号大师|com.qtrun.QuickTest
小米有品|com.xiaomi.youpin
一加天气|net.oneplus.weather
创意氢壁纸|com.xyznh.makeimageqin
EasyTouch虚拟键|com.shere.easytouch
GO短信|com.jb.gosms
为知笔记|cn.wiz.note
时光网|com.mtime
网易考拉|com.kaola
雅虎天气|com.yahoo.mobile.client.android.weather
网易云阅读|com.netease.pris
中国大学MOOC|com.netease.edu.ucmooc
搜索 Lite|com.orekie.search
Android System WebView|com.google.android.webview
腾讯文件-微信QQ文件极速查找|com.tencent.FileManager
微盘|com.sina.VDisk
正点日历|com.zdworks.android.zdcalendar
连网神器|com.autoconnectwifi.app
随e行WiFi|com.chinamobile.cmccwifi
VUEVlog|video.vue.android
金山手机卫士|com.ijinshan.mguard
华为主题纯粹轻雨版  EMUI5/8/9.0|emui.en.com.pure
高铁管家|com.gtgj.view
掌上电力|com.sgcc.cs
Holi天气|com.joe.holi
360浏览器|com.qihoo.browser
照片编辑器:Photo Editor|com.iudesk.android.photo.editor
GO天气EX|com.gau.go.launcherex.gowidget.weatherwidget
动漫之家|com.dmzj.manhua
神奇浏览器|com.z28j.feel
欧朋浏览器|com.oupeng.mini.android
书旗小说|com.shuqi.controller
Auto.js|com.stardust.scriptdroid
锤子桌面|com.smartisanos.home
WeLike微博客户端|com.sxy.ui
开卷小说|com.kingreader.framework
口碑|com.taobao.mobile.dipei
滴答清单|cn.ticktick.task
哔哩哔哩概念|com.bilibili.app.blue
Airbnb爱彼迎|com.airbnb.android
全能工具箱|imoblife.toolbox.full
豆瓣电影|com.douban.movie
钱迹-记账小能手|com.mutangtech.qianji
平安口袋银行|com.pingan.pabank.activity
简书|com.jianshu.haruki
百度浏览器|com.baidu.browser.apps
丁香医生|cn.dxy.android.aspirin
360优化大师|com.qihoo360.mobilesafe.opti
阅读星免费小说|com.iBookStar.activity
锤子便签|com.smartisan.notes
掌上出行|com.mygolbs.mybus
掌阅|com.chaozh.iReaderFree
快递100|com.Kingdee.Express
1号店|com.thestore.main
手机电视|dopool.player
按键精灵|com.cyjh.mobileanjian
易迅网|com.icson
影视大全|com.le123.ysdq
Oblatum 图标|com.oblatum.iconpack
猎豹清理大师精简版|com.cmcm.lite
豆果美食|com.douguo.recipe
微博极速版|com.sina.weibolite
触宝输入法国际版|com.emoji.keyboard.touchpal
ROOT精灵|com.shuame.rootgenius
二维码扫描|com.youba.barcode
隐藏图|com.imlk.BlackAndWhite
净化大师-广告净化助手|com.kingroot.master
网易邮箱|com.netease.mobimail
美拍|com.meitu.meipaimv
MIUI音乐|com.miui.player
双开助手|com.excelliance.dualaid
第一弹-二次元社区|com.diyidan
华为手机文件管理器|com.huawei.hidisk
茄子快传|com.lenovo.anyshare
Google文件极客|com.google.android.apps.nbu.files
风行视频|com.funshion.video.mobile
YUE:你的随身阅读电台|fm.yue.android
网盘搜索神器|top.itziyuan.www.panso
NGA客户端开源版|gov.anzong.androidnga
悟空遥控器|com.wukongtv.wkremote.client
人人|com.renren.mobile.android
网速测试大师|com.quickbird.speedtestmaster
万能影视|com.omnivideo.video
文件管理器的ASTRO|com.metago.astro
京东钱包|com.wangyin.payment
Smart Switch|com.sec.android.easyMover
荔枝|com.yibasan.lizhifm
Photoshop  v1.3.2|com.adobe.psmobile
Aris-终端桌面|shinado.indi.piping
CaptiveMgr清除x和!|tech.evlsoc.captivemgr
沃邮箱|com.asiainfo.android
护目镜增强版（屏幕调节器）(MyAppScreenMask)|cn.mixiaoxiao.myappscreenmask
猿题库|com.fenbi.android.gaozhong
酷我听书FM|cn.kuwo.tingshu
福昕PDF阅读器|com.foxit.mobile.pdf.lite
Aviate|com.tul.aviate
File Commander|com.mobisystems.fileman
识货|com.hupu.shihuo
斗图神器|com.bugua.fight
西瓜视频|com.ss.android.article.video
数字尾巴|com.funinput.digit
Syslock|com.lerist.syslock
Cheetah Browser|com.ksmobile.cb
豆瓣阅读|com.douban.book.reader
HTC音乐|com.htc.music
微软必应词典|bingdic.android.activity
行者骑行|im.xingzhe
兽耳桌面|com.mimikko.mimikkoui
OriginalWish图标包|com.atony.iconpack.originalwish
EMore|com.caij.emore
前程无忧51Job|com.job.android
可可英语|com.kekeclient_
网络解锁助手|com.example.unlock
一本日记|com.chenupt.day
三星生活助手|com.samsung.android.app.sreminder
返利|com.fanli.android.apps
掌上营业厅|com.jsmcc
禁用服务:Disable Service|cn.wq.disableservice
金山电池医生|com.ijinshan.kbatterydoctor
随笔记|org.dayup.gnotes
掌中英语|com.zzenglish.client
小睡眠|com.psyone.brainmusic
猎豹浏览器极速版|com.ijinshan.browser_fast
网易蜗牛读书|com.netease.snailread
VIPERFX 音效驱动 正式版 v2.5.0.5|com.audlabs.viperfx
微软翻译:Microsoft Translator|com.microsoft.translator
Mix|com.pinguo.edit.sdk
米聊（视频聊天交友）|com.xiaomi.channel
快牙国际版|com.dewmobile.kuaiya.play
驾校一点通|com.jxedt
以图搜图|rikka.searchbyimage
聚力视频HD|com.pplive.androidpad
氢桌面内测版|com.oneplus.hydrogen.launcher
中华万年历|cn.etouch.ecalendar
高级手机助手|com.iobit.mobilecare
万达电影|com.wandafilm.app
星巴克|com.starbucks.cn
WP桌面|com.lx.launcher
HTC相册|com.htc.album
App Ops|rikka.appops
粉笔|com.fenbi.android.servant
爱看阅读|com.mdroid.read
懂球帝|com.dongqiudi.news
核桃助手梦梦奈|org.alie.momona
文件大师|xcxin.filexpert
魅族天气|com.meizu.flyme.weather
嘀嗒出行|com.didapinche.booking
慕课网|cn.com.open.mooc
分期乐|com.fenqile.fenqile
小米系统|com.miui.miuilite
快看漫画|com.kuaikan.comic
智能连接:LiveWare|com.sonyericsson.extras.liveware
网商银行|com.mybank.android.phone
一句|small.word
氢应用|pub.hydrogen.android
战旗直播|com.gameabc.zhanqiAndroid
Boss直聘|com.hpbr.bosszhipin
火萤|com.znxh.hyhuo
铁友火车票-12306抢票|com.tieyou.train.ark
扇贝阅读|com.shanbay.news
橙子VR|com.chengzivr.android
H5浏览器|org.noear.h5
多邻国免费学英语|com.duolingo
古诗词典|com.kk.poem
Daniu大牛|com.deniu.daniu
羽·浏览器|com.mokee.yubrowser
黄油相机|com.by.butter.camera
企业微信|com.tencent.wework
猎豹安全大师国际版:CM Security|com.cleanmaster.security
安居客一二手房新房租房|com.anjuke.android.app
魔力视频播放器-高清万能流媒体|com.moliplayer.android
最美天气|com.icoolme.android.weather
Opera 浏览器 beta|com.opera.browser.beta
赶集网|com.ganji.android
中信银行动卡空间|com.citiccard.mobilebank
海贝音乐|com.hiby.music
Hola桌面|com.hola.launcher
艺龙旅行|com.dp.android.elong
Nokia Z Launcher|com.nokia.z
微风天气|com.iwoll.weather
SleepTown|seekrtech.sleep
唐僧藏经|com.dahuo.sunflower.xad
氢壁纸视频桌面|com.hydrogen.video.lwp
课程格子-小课表，大格局|fm.jihua.kecheng
聊天宝|com.bullet.messenger
拼立得|com.instamag.activity
坚果云|nutstore.android
便签|xyz.hanks.note
米侠浏览器|mixiaba.com.Browser
Microsoft远程桌面|com.microsoft.rdc.android
微店|com.koudai.weidian.buyer
Dr.COM客户端|com.drcom.Android.DrCOMWS
音悦Tai|com.yinyuetai.ui
Device Info HW|ru.andr7e.deviceinfohw
Adobe® Photoshop® Touch|air.com.adobe.pstouch
彩云天气|com.nowcasting.activity
卡牛信用管家|com.mymoney.sms
布丁动画|in.huohua.Yuki
LinkedIn领英|com.linkedin.android
来电通:CallMaster|com.blovestorm
Office Lens|com.microsoft.office.officelens
美柚-大姨妈月经期助手|com.lingan.seeyou
图片拼接PPIICC|bos.consoar.imagestitch
Fusion App-所有网页都是客户端|cn.coldsong.fusionapp
移形换影|net.anylocation
酷米客|com.coomix.app.bus
安卓动态壁纸|com.androidesk.livewallpaper
房天下一新房二手房租房买房搜房房价|com.soufun.app
轻芒阅读|com.wandoujia
Mysplash 摄影&壁纸|com.wangdaye.mysplash
格瓦拉生活|com.gewara
他趣|com.xingjiabi.shengsheng
不背单词|cn.com.langeasy.LangEasyLexis
买单吧|com.bankcomm.maidanba
Autodesk SketchBook Mobile|com.sketchbook
天眼查|com.tianyancha.skyeye
记忆碎片|com.jyye.memento
远离手机3.0—摆脱手机束缚|com.lijianqiang12.silent
咕咚|com.codoon.gps
掌上道聚城|com.tencent.djcity
拾乐|obdv.cf.tool.musicassistant
小米快传|com.xiaomi.midrop
Office Mobile for Office 365|com.microsoft.office.officehub
安全管家|com.anguanjia.safe
超级视频|com.chaojishipin.sarrs
左下图标包|com.zuoxia.iconpack
小米文件管理器:Mi File Explorer|com.android.mifileexplorer
魔力视频HD|com.molitvhd.android
知趣天气|com.metek.zqWeather
短片大师:Movie Creator|com.sonymobile.moviecreator.rmm
泼辣修图|photo.editor.polarr
酷6视频|com.ku6.client.ui
企鹅电竞|com.tencent.qgame
夜间屏幕|info.papdt.blackblub
淘宝联盟|com.alimama.moon
搜狗浏览器|sogou.mobile.explorer
WiFi管家—轻松连上好wifi|com.tencent.wifimanager
大麦-演唱会、电影、话剧，应有尽有！|cn.damai
小恩爱|com.xiaoenai.app
爱卡汽车|com.xcar.activity
Cuto壁纸|com.sspai.cuto.android
魅族音乐|com.meizu.media.music
息屏提醒 - SmileSoft|com.smileide.aodService
澎湃新闻|com.wondertek.paper
MBE Style 图标包|me.iacn.mbestyle
轻听|com.tencent.qqmusiclocalplayer
沪江开心词场|com.hjwordgames
游戏蜂窝|com.cyjh.gundam
360清理大师|com.qihoo.cleandroid_cn
百度输入法一加专版|com.baidu.input_yijia
花生地铁|com.nfyg.hsbb
Quik — GoPro视频编辑器|com.stupeflix.replay
浙江移动手机营业厅|com.example.businesshall
最美壁纸|com.brixd.wallpager
路路通手机时刻表|com.lltskb.lltskb
运动修改器|com.qqyundongxiugaiqi
Smart锁屏|com.wandoujia.roshan
StarDust|com.chaozhuo.browser_phone
微信电话本|com.tencent.pb
快手下载|com.kandian.hdtogoapp
国泰君安君弘|com.guotai.dazhihui
学霸君-作业答疑帮手|com.wenba.bangbang
HTC Sense首页|com.htc.launcher
365日历万年历农历|com.when.coco
小黑屋|web1n.stopapp
黑白门|com.example.bwappdoor
快快查汉语字典|com.kk.dict
Firefox Beta|org.mozilla.firefox_beta
51信用卡管家|com.zhangdan.app
秒拍|com.yixia.videoeditor
映客|com.meelive.ingkee
猎豹浏览器|com.ijinshan.browser
坏分数PLUS|com.zzh.hfs.plus
Pure - Substratum主题|cn.lirui.pure
掘金|com.daimajia.gold
悦动圈|com.yuedong.sport
宝宝树孕育|com.babytree.apps.pregnancy
欧朋浏览器|com.oupeng.browser
番茄ToDo|com.plan.kot32.tomatotime
猎豹免费WiFi|com.ijinshan.kwifi
斗鱼直播PRO|tv.douyu
锤子BigBang|com.forfan.bigbang
智能360-语音助手|com.voice.assistant.main
皮皮虾|com.sup.android.superb
Nike+ Running|com.nike.plusgpschina
简洁日历|com.scliang.bqcalendar
脉脉|com.taou.maimai
极速浏览器|com.qihoo.contents
云舟浏览器:Boat Browser|com.boatbrowser.free
投屏神器|com.xiaomi.mitv.phone.tvassistant
正点工具箱|com.zdworks.android.toolbox
TickTick|com.ticktick.task
航班管家|com.flightmanager.view
HTC 浏览器:HTC Internet|com.htc.sense.browser
酷安日图|com.by_syk.cooldp
带壳截图by少数派|com.sspai.dkjt
啪啪游戏厅|com.join.android.app.mgsim
遇见|net.iaround
触手直播|com.kascend.chushou
链家一二手房租房新房|com.homelink.android
墨墨背单词|com.maimemo.android.momo
拉勾招聘|com.alpha.lagouapk
AutoCAD 360|com.autodesk.autocadws
黑白隐藏图|com.xyznh.imgblack
小圆角|com.c4x.roundcorner
途牛旅游-酒店机票火车票景点门票|com.tuniu.app.ui
今日头条极速版|com.ss.android.article.lite
玩图－全能美化|com.wantu.activity
天涯社区|cn.tianya.light
国美|com.gome.eshopnew
言情小说吧|cn.xs8.app
英语流利说|com.liulishuo.engzo
铃声编辑专家:Ringdroid|com.ringdroid
图吧导航(3D地图)|com.mapbar.android.mapbarmap
交通银行|com.bankcomm.Bankcomm
PlayStation App|com.scee.psxandroid
Pelmix图标包|com.edward.iconpack.pelmix
微视(送红包)|com.tencent.weishi
韩剧TV|com.babycloud.hanju
生活轨迹|com.sonymobile.lifelog
一加5刷机盒子|com.daxiaamu.op5mutoolsnew
搜狗地图（免费语音导航）|com.sogou.map.android.maps
聚划算|com.taobao.ju.android
钱盾|com.ali.money.shield
邮储银行|com.yitong.mbank.psbc
Booking全球酒店预订|com.booking
STM10录音器|com.sonymobile.androidapp.audiorecorder
一言|com.hitokoto
Neets|com.haitun.neets
老子搜书|com.eonsun.myreader
简悬浮|com.bs.smarttouch
echo回声|com.kibey.echo
向日葵远程控制|com.oray.sunlogin
百度知道|com.baidu.iknow
nice|com.nice.main
WTV影视大全|com.rumtel.mobiletv
CPU Monitor|com.glgjing.stark
无他相机|com.benqu.wuta
POCO相机|my.PCamera
酷音铃声-铃声大全|com.iflytek.ringdiyclient
搜索重复文件|com.needjava.findersuper
车轮查违章-违章查询|cn.eclicks.wzsearch
藏书馆|com.cliff
边缘任务（手势切换悬浮工具栏）|com.gesture.s
WiFi路由管家|com.bhu.wifioverlook
APlayer|remix.myplayer
Tapet|com.sharpregion.tapet
魔拍|com.baidu.baiducamera
得到|com.luojilab.player
CIBN微视听|net.myvst.v2
GIF字幕菌 - 制作好玩的GIF|immortalz.me.zimujun
英雄联盟LOL掌游宝|com.anzogame.lol
Solo桌面|home.solo.launcher.free
CAJ云阅读|com.cnki.android.cajviewercloud
SketchBook Pro for Tablets|com.adsk.sketchbookhd
阿里小号|com.alicom.smartdail
落网|net.luoo.LuooFM
淘宝全球|com.taobao.htao.android
MONO|com.mmmono.mono
春雨医生|me.chunyu.ChunyuDoctor
光大银行手机银行|com.cebbank.bankebb
扇贝听力|com.shanbay.listen
Opera Mobile Classic|com.opera.browser.classic
QKADM|com.vanda_adm.vanda
冷桌面|net.ohrz.coldlauncher
每日英语听力|com.eusoft.ting.en
联想超级相机|com.lenovo.scg
乐安全|com.lenovo.safecenter
Apple Music|com.apple.android.music
酷狗铃声|com.kugou.android.ringtone
网易漫画|com.netease.cartoonreader
折800-独家折扣优惠买|com.tuan800.tao800
XMind思维导图|net.xmind.doughnut
点点虫|com.alibaba.android.babylon
游民星空|com.gamersky
有料|cn.kuaipan.android
惠惠购物助手|com.youdao.huihui.deals
Q立方桌面|com.tencent.qlauncher
水印相机|com.tencent.zebra
WiFi密码|com.wifi.password
拉手团购美食购物酒店电影票婚纱照|com.lashou.groupurchasing
MoboPlayer|com.clov4r.android.nil
500px摄影分享|com.fivehundredpx.viewer
镧·Cpu跑分|com.xzr.La.bench
好豆|com.haodou.recipe
蘑菇街|com.mogujie
东方财富|com.eastmoney.android.berlin
应用备份和还原|mobi.infolife.appbackup
百度新闻|com.baidu.news
穷游|com.qyer.android.jinnang
索爱桌面:Xperia Home|com.sonyericsson.home
BeautyPlus|com.commsource.beautyplus
PIP Camera|com.pipcamera.activity
Autodesk SketchBook|com.adsk.sketchbook
慢慢买比价购物助手|com.manmanbuy.bijia
战网手机安全令国际版|com.blizzard.bma
NIKE+ Running 国际版|com.nike.plusgps
极路由|com.hiwifi
何时|bos.consoar.countdown
斐讯路由|com.phicomm.cloud.soho.router
遥控精灵play版|com.tiqiaa.remote
猎聘|com.lietou.mishu
知米背单词|cn.edu.zjicm.wordsnet_d
讯飞语记|com.iflytek.vflynote
奥维互动地图|com.ovital.ovitalMap
搜狗号码通|com.sg.sledog
抬手唤醒 - 解锁一气呵成|com.kongzue.wakeup
番茄土豆|com.pomotodo
锤子图标|com.frowhy.smartisan
不做手机控|com.pl.getaway.getaway
联想日历|com.lenovo.calendar
倒数日|com.clover.daysmatter
同程旅游-特价门票.旅行机票.酒店|com.tongcheng.android
MYOTee脸萌（拼出你的卡通头像）|com.miantan.myoface
百度输入法 for pad|com.baidu.padinput
新长大助手|com.yangtzeu
悦跑圈|co.runner.app
Peel万能遥控器|tv.peel.app
流量银行|com.flowbank.wo
滴滴车主|com.sdu.didi.gsui
用药助手|cn.dxy.medicinehelper
智能锁屏 - SmileSoft                                                         (有抬手,通知亮屏等唤醒功能)|com.SmileIDE.SmartLock
完事儿|com.ywwynm.everythingdone
图解电影|com.wzm.moviepic
YohoBuy有货|com.yoho
潮汐|io.moreless.tide
乐动力|cn.ledongli.ldl
馒头地球|ooo.oxo.apps.earth
乐视体育|com.lesports.glivesports
百度钱包|com.baidu.wallet
微众银行|com.webank.wemoney
超级计算器|com.youdao.calculator
Microsoft Edge|com.microsoft.emmx
Polaris Office + PDF|com.infraware.office.link
个人所得税|cn.gov.tax.its
网上厨房-美食菜谱|cn.ecook
果壳精选|com.guokr.android
51万年历|com.youloft.calendar
Nokia Evolve+图标包|com.wanmonstar.nokiaevolveplus
FxCamera特效相机|ymst.android.fxcamera
聚美优品-时尚特卖商城|com.jm.android.jumei
掌上穿越火线|com.tencent.qt.sns
火山小视频|com.ss.android.ugc.live
滑稽图标包|kh.android.funnyiconpack
HERE WeGo|com.here.app.maps
懒人天气|com.easylife.weather
太平洋电脑网|cn.com.pconline.android.browser
奇妙清单|com.wunderkinder.wunderlistandroid
花粉俱乐部|com.huawei.fans
氢相机|com.oneplus.camera
百度阅读|com.baidu.yuedu
八戒助手2|com.dahuo.sunflower.assistant.gestures
录屏大师|com.screeclibinvoke
轻文轻小说|in.iqing.app
二维码扫描|mark.qrcode
海词词典|cn.dict.android.pro
京东到家|com.jingdong.pdj
Uber优步中国|com.didi.echo
强力监测:Powerful Monitor|com.glgjing.marvel
APUS|com.apusapps.launcher
绿茶浏览器|com.lenovo.browser
APK编辑器|zhao.apkmodifier
考研帮|com.tal.kaoyan
生活日历|me.iweek.rili
强力清理|com.glgjing.hawkeye
多玩饭盒|com.duowan.lolbox
随身乐队|com.gamestar.pianoperfect
纯纯打码 - 让打码也能赏心悦目|me.drakeet.puremosaic
凤凰视频|com.ifeng.newvideo
Win10安卓桌面|com.xpping.windows10
易到|com.yongche.android
LBE加速大师|com.lbe.security.prime
Sunmiconpack图标包|com.by_zen.sunmiconpack
百度浏览器国际版:Baidu Browser|com.baidu.browser.inter
极简汇率|com.tratao.xcurrency
时光相册|tc.everphoto
炼妖壶（Island）|com.oasisfeng.island
ES任务管理器|com.estrongs.android.taskmanager
旅法师营地|com.gonlan.iplaymtg
Socialife|com.sony.nfx.app.sfrc
娱票儿|com.tencent.movieticket
网速指示计|me.zheteng.android.powerstatus
氢桌面|net.oneplus.h2launcher
浦发信用卡|com.spdbccc.app
小影-微视频DIY神器|com.quvideo.xiaoying
爱奇艺视频HD|com.qiyi.video.pad
凯立德导航|cld.navi.mainframe
HTC 时钟|com.htc.android.worldclock
Xperia乐享汇:Xperia™ LOUNGE|com.sonyericsson.xhs
5sing原创音乐|com.sing.client
手机性能排行|com.nasoft.socmark
腾讯自选股（腾讯官方炒股软件）|com.tencent.portfolio
京东阅读|com.jingdong.app.reader
壁虎数据恢复|mobi.bihu.recovery
岁寒输入法|com.suihan.version3
漫画台|com.comic.manhuatai
百姓网|com.quanleimu.activity
一加桌面|net.oneplus.launcher
腾讯翻译君|com.qb.qtranslator
理理相册|com.btows.photo
CAD快速看图|com.glodon.drawingexplorer
HTC Dot View|com.htc.dotmatrix
小米省钱购|com.xiaomi.o2o
必应bing|com.microsoft.bing
知到|com.able.wisdomtree
抽屉新热榜|com.gozap.chouti
动动计步器|cc.pacer.androidapp
人脸解锁 - SmileSoft|com.smile.facelock
Outlook.com|com.outlook.Z7
咪咕音乐|cmccwm.mobilemusic
巧影|com.nexstreaming.app.kinemasterfree
Flyme画板|com.meizu.media.painter
炉石传说掌游宝|com.anzogame.hs
HTC 任务|com.htc.task
谷歌服务FC修复工具|com.goplaycn.gappsrepair
360家庭防火墙|com.qihoo.srouter.n300
腾讯课堂|com.tencent.edu
智能证件照|com.leqi.idpicture
XyKey|com.naxy.xykey
极简桌面|com.jeejen.family
网极SWF播放器|com.webgenie.swf.play
乐同步|com.lenovo.leos.cloud.sync
TP-LINK|com.tplink.cloudrouter
迅雷快鸟|com.xunlei.vip.swjsq
小书亭|com.qihoo.haosou.subscribe.vertical.book
酷安装:无root自动安装|com.coolapk.autoinstaller
Android控制中心|com.litesuits.control
辣品|com.ruanmei.lapin
天天快报-腾讯兴趣阅读平台|com.tencent.reading
沪江小D词典|com.hujiang.dict
暴风魔镜Pro|com.baofeng.mj
系统软件卸载|cn.ifreedomer.com.softmanager
听伴|com.itings.myradio
好轻|com.yunmai.scale
HTC天气|com.htc.Weather
Adobe Lightroom mobile|com.adobe.lrmobile
微锁屏|com.vlocker.locker
Smalite图标包|com.sjk.smaliteiconpack
快读免费小说|com.freereader.kankan
诗鲸|me.javayhu.poetry
百度日文输入法(simeji)|com.adamrocker.android.input.simeji
Opera Mini|com.opera.mini.native
优联WiFi|com.pingan.pinganwifi
美图GIF|com.mt.mtgif
华住酒店|com.htinns
Qpay|com.wokee.qpay
企鹅FM-听小说相声情感音乐|com.tencent.radio
心悦俱乐部|com.tencent.tgclub
Gif助手|com.didikee.gifparser
锤子阅读|com.smartisan.reader
华为运动健康|com.huawei.health
工银融e联|com.icbc.im
陆金所|com.lufax.android
Flyme便签|com.meizu.notepaper
会话微件|com.example.raccoon.dialogwidget
广发信用卡发现精彩|com.cs_credit_bank
lineicons图标包2|com.crazypig321.lineicons2
抱抱|cn.myhug.baobao
360流量卫士|com.qihoo.vpnmaster
彭博商业周刊|cn.com.modernmedia.businessweek
AndroVid|com.androvidpro
平行空间(原双开大师)国际版|com.lbe.parallel.intl
360美化桌面（home）|com.qihoo360.ilauncher
GO省电|com.gau.go.launcherex.gowidget.gopowermaster
8684地铁|cn.chinabus.metro.main
第二空间 - 保护你的小秘密|com.hld.anzenbokusu
读读日报|com.zhihu.circlely.android
窝牛装修|com.lingduo.acorn
百度百科|com.baidu.baike
水印|com.yaerin.watermark
乐词－新东方背单词|com.xdf.recite
足记|cc.fotoplace.app
豆丁书房|com.docin.zlibrary.ui.android
账号本子|com.wei.account
爱听4G|com.imusic.iting
Snapmod - 带壳截图|cn.gavinliu.snapmod
Fotor照片编辑器|com.everimaging.photoeffectstudio
IN|com.jiuyan.infashion
8684火车|cn.lieche.main
推酷|com.tuicool.activity
山东移动|com.xwtec.sd.mobileclient
简悬浮 Pro|com.bs.smarttouchpro
Clipboard Plus|cn.cyt.clipboardplus
自如|com.ziroom.ziroomcustomer
蜡笔同步|com.gozap.labi.android
锤子日历|com.smartisan.calendar
OnePlus Pro|l.o
最最日语|com.voltmemo.xz_cidao
巴士管家|com.chebada
网易将军令|com.netease.mkey
网易有钱记账|com.netease.moneykeeper
CM桌面|com.ksmobile.launcher
一直播|tv.xiaoka.live
有券助手|com.youquan.helper
ZEALER|com.zealer.app
拉卡拉|com.lakala.android
PlayMemories Mobile|com.sony.playmemories.mobile
手机加速神器|cn.am321.android.am321
分身大师|com.qihoo.magic
坏坏猫搜索|com.hhmss.verticalsearch
FastMiui|com.fox.miui
Memrise|com.memrise.android.memrisecompanion
和通讯录|com.chinamobile.contacts.im
生日管家|com.octinn.birthdayplus
南方航空|com.csair.mbp
简拼|cn.poco.jane
Xperia Transfer Mobile|com.sonymobile.xperiatransfermobile
多看阅读HD|com.duokan.hdreader
Xperia日历|com.sonymobile.calendar
西窗烛|com.hustzp.com.xichuangzhu
收趣|com.shouqu.bookmarklife
电池管家|com.glgjing.thor
煎蛋|com.danielstudio.app.wowtu
天天看|com.tiantiankan.ttkvod
搜狗阅读|com.sogou.novel
美妆相机|com.meitu.makeup
河南移动手机营业厅|com.xinhang.mobileclient
好好住|com.hzhu.m
拓词-上瘾背单词|com.towords
网易火车票|com.netease.railwayticket
BlackPlayer|com.kodarkooperativet.blackplayerfree
小妖精美化|com.xjlmh.classic
水表助手|info.papdt.express.helper
火猫直播|com.huomaotv.mobile
简洁·日历|com.jjrili.app
电视家|com.dianshijia.tvlive
QQ音乐HD|com.tencent.qqmusicpad
ASMR|com.lbrvan.asmr
一加便签|com.oneplus.note
换机助手-同步传输|com.tencent.transfer
网极SWF & Flash播放器 - 支持Android 8.0|com.webgenie.swfplay2
俯卧撑教练:Push Ups pro|com.northpark.pushups
平安金管家|com.pingan.lifeinsurance
FitTime|com.rjfittime.app
思维简图|com.taguage.whatson.easymindmap
超级清理加速|com.ccmt.supercleaner
GTasks日程管理|org.dayup.gtask
滚动截图|me.pkhope.longscreenshot
花瓣|com.huaban.android
途虎养车|cn.TuHu.android
Launcher Lab|com.gtp.launcherlab
HUAWEI Mobile WiFi 2|com.huawei.mw
遥控专家酷控|com.kookong.app
最美锁屏|com.zuimeia.suite.lockscreen
初页|com.cloud7.firstpage
WakeUp课程表|com.suda.yzune.wakeupschedule
可编程科学计算器:Scientific Calculator Plus|com.cyzapps.AnMath
飞鸽传书官方版|com.netfeige
简单搜索|com.baidu.searchcraft
一加搬家|com.oneplus.backuprestore
测速大师|com.syezon.lab.networkspeed
Big Font (改变系统字体大小)|com.a0soft.gphone.bfont
爱看4G|com.telecom.video.ikan4g
形色|cn.danatech.xingseapp
必应输入法|com.bingime.ime
美丽说|com.meilishuo
机器人9号（QQ微信聊天机器人）|robot9.robot.deified.com.robot9
图凌|com.chan.cwallpaper
极相机|com.jb.zcamera
POCO桌面|com.mi.android.globallauncher
轻桌面|net.ohrz.lightlauncher
Toucher Pro|com.gau.go.toucherpro
防蹭网大师|com.fcwds.wifiprotect
太平洋汽车网|cn.com.pcauto.android.browser
魅族便签|com.meizu.notes
好游快爆|com.xmcy.hykb
抢手|com.chongdingdahui.app
即刻运动|com.fittimellc.fittime
MTK Mode|com.cpf.mtkmode
AreYouBatteryOk (电池损耗检测)|moe.johnny.areyouok
随手写|com.fiistudio.fiinote
36氪|com.android36kr.app
随身天气|com.sscwap
咪咕视频|com.cmcc.cmvideo
潮自拍|com.meitu.wheecam
广州地铁官方APP|com.infothinker.gzmetro
章鱼TV|com.zhangyu
文件管理|com.oneplus.filemanager
WPS邮箱|com.kingsoft.email
知乎极速版|com.zhihu.android.lite
懂车帝|com.ss.android.auto
华为钱包|com.huawei.wallet
凡客诚品 VANCL|com.vancl.activity
3D播播VR|com.bobo.splayer
微光|com.qingqi.dianbo
Screen投屏|com.tav.screen
护眼宝|protect.eye
待办事项:Microsoft To-Do|com.microsoft.todos
金太阳手机炒股|com.guosen.android
面包猎人|com.breadtrip
开发者助手|com.toshiba_dealin.developerhelper
腾讯游戏管家-王者荣耀|com.tencent.gamestick
Timi时光记账|com.talicai.timiclient
地下城与勇士DNF掌游宝|com.anzogame.game
章鱼输入法|com.komoxo.octopusime
一起沃|com.unicom.yiqiwo
坐车网(公交查询地铁)|com.ourlinc
时间轮盘|com.suda.datetimewallpaper
华为主题 XIN EMUI8.0|cn.coldsong.xin2
预览图标包|com.scrymile.iconpack.yulan
CSDN|net.csdn.csdnplus
图虫|com.ss.android.tuchong
优美图|me.topit.TopAndroid2
小米小说|com.duokan.fiction
界面新闻-500位CEO的强力推荐|com.jiemian.news
咕咚翻译|name.gudong.translate
超卓文件管理器|com.chaozhuo.filemanager
券妈妈优惠券|com.android.app.quanmama
一键锁屏|com.mokee.lockscreen
华尔街见闻|com.wallstreetcn.news
英语 ✓|com.zjp.translateit
斗鱼HD|com.douyu.hd.air.douyutv
讯飞有声|com.iflytek.readassistant
爱帮公交|com.aibang.abbus.bus
索尼商城|com.sony.store.china
NFC Tools|cc.metapro.nfc
出国翻译官|com.qicai.translate
Ticwear助手|com.mobvoi.companion
小熊油耗|com.firebear.androil
广发手机银行|com.cgbchina.xpt
新浪体育|cn.com.sina.sports
神州专车|com.szzc.ucar.pilot
阿里云|com.alibaba.aliyun
印象|cn.poco.interphoto2
微店店长版|com.koudai.weishop
丁香园|cn.dxy.idxyer
X Home Bar|com.lagache.sylvain.xhomebar
民生银行|cn.com.cmbc.mbank
礼物说|com.liwushuo.gifttalk
WiFi Service|com.jhj.dev.wifi
手机克隆|com.hicloud.android.clone
非Root版微信自动回复|com.example.asus.lghwxautoreply
快点投屏|com.wukongtv.wkcast
屏幕录像|dev.nick.app.screencast
猫耳FM|cn.missevan
局域网精灵|com.xchat.stevenzack.langenius
按摩棒|com.github.xiaofei_dev.vibrator
搜书王|com.soushuwang.book
盒马|com.wudaokou.hippo
爱范儿|com.ifanr.activitys
Next Lock Screen|com.microsoft.next
轻松护眼|com.netease.protecteyes
WPS便签|cn.wps.note
优衣库|com.yek.android.uniqlo
录音宝|com.iflytek.recinbox
美食杰家常菜谱大全|com.jesson.meishi
闪传|cn.andouya
豆瓣一刻|com.douban.daily
四川移动掌上营业厅|com.sunrise.scmbhc
氢风-Substratum主题|cn.luojuly.HSTYLES
HTC涂鸦板:HTC Scribble|com.htc.lucy
折腾六块腹肌|com.runtastic.android.sixpack.lite
K歌达人|com.app.hero.ui
兼职猫|all.parttimeguidesystem
薄荷健康|com.boohee.one
天天基金|com.eastmoney.android.fund
10086|zz.dela.cmcc.traffic
蜗牛睡眠|com.seblong.idream
旗鱼浏览器|com.ruanmei.qiyubrowser
凤凰FM|com.ifeng.fhdt
舒心录 - 永不割舍回忆备忘录|com.myatejx.sakernote
Fitbit|com.fitbit.FitbitMobile
蒸汽帮 for Steam|com.happyteam.steambang
极邮邮箱|cn.jadenine.himail
沙发管家|com.shafa.market
Passport - 安全干净的密码管理器|cn.ifengge.passport
天翼视讯电视视频播放器|com.telecom.video
首旅如家|com.ziipin.homeinn
PP体育|com.pplive.androidphone.sport
企查查企业信用查询|com.android.icredit
猎豹备份大师:Backup Master|com.ijinshan.backupmaster
闪烁保护|org.js.oledsaver
谁叫我起床|com.jianjian.clock.activity
哔哩哔哩漫画|com.bilibili.comic
W3Cschool编程学院|cn.w3cschool.app
场库|vmovier.com.activity
LawnchairQa启动器|ch.deletescape.lawnchair.qa
锤子时钟|com.smartisan.clock
节操精选|com.jiecao.news.jiecaonews
花田|com.netease.huatian
luckincoffee|com.lucky.luckyclient
陶猫-Eternal TF一键领取王者荣耀 斗破苍穹 全军出击 QQ飞车活动 成长值一键领取|com.mengtaowangluo
Aeroblast图标包|com.markusslugia.iconpack.aeroblast
瓜子二手车|com.ganji.android.haoche_c
iWeekly|com.rakutec.android.iweekly
神州租车|com.szzc
QQ桌面|com.tencent.qqlauncher
唯乐|com.yf.smart.weloopx.dist
顺丰优选|com.sfbest.mapp
新版中日交流标准日本语|com.PEP.biaori
bilibili link|com.bilibili.bilibililive
兴业银行|com.cib.cibmb
Zone悬浮球|com.mixiaoxiao.touchassistant
扇贝英语|com.shanbay.sentence
Nature图标包|com.nature.iconpack
口袋购物|com.geili.koudai
趣头条|com.jifen.qukan
MBA智库|com.mbalib.android.wiki
汽车违章查询|cn.mucang.kaka.android
民生银行手机银行|cn.com.cmbc.newmbank
一闪|com.blink.academy.onetake
Mistiness 弥散 图标包|person.cjy.iconpack.mistiness
Blurone创作毛玻璃壁纸&iPhone X效果dock栏|com.nexdev.blurone
种子习惯|com.idothing.zz
幕布|com.mubu.app
BestMe自拍相机|com.rcplatform.selfiecamera
ENJOY|com.ricebook.highgarden
电影天堂|com.bzh.dytt
黑洞 隐藏/冻结|com.hld.apurikakusu
百度输入法小米V6版|com.baidu.input_miv6
ApkCrack|zhao.apkcrack
盖得排行|com.icloudoor.bizranking
腾讯桌面|com.tencent.launcher
简单读书|com.example.txtreader
成语词典|org.hisand.android.chengyu
安卓清理大师:360 Clean Droid|com.qihoo.cleandroid
微信锁|com.apkol.lockwechat
人民日报|com.peopledailychina.activity
点心桌面|com.dianxinos.dxhome
联想文件管家|com.lenovo.FileBrowser
黄历万年历|com.when.wannianli
中国天气|com.hf
沃钱包|com.unicom.wopay
上海移动掌上营业厅|com.sh.cm.busihall
CAD看图王|com.gstarmc.android
荟萃浏览器|cn.uujian.browser
华硕路由器|com.asus.aihome
Microsoft Remote Desktop Beta|com.microsoft.rdc.android.beta
菠萝包轻小说|com.sfacg
智能公交|com.edcsc.wbus
牛客|com.nowcoder.app.florida
qq清理|com.cleanerforqq
360行车记录仪|com.qihoo.dr
小米社区|com.xiaomi.bbs
永安行|com.ibike.publicbicycle.activity
顺历|oms.mmc.fortunetelling.gmpay.almanac2
记助|com.pybeta.daymatter
小米违章查询|cn.mucang.xiaomi.android
测网速|com.uusense.speed
老司机|com.feng.car
好大夫在线|com.haodf.android
Next ZUK - ZUK工具箱|cn.bavelee.next.zukbox
护眼宝精简版|protect.eye.filterv
魅族社区|com.meizu.flyme.flymebbs
开心网|com.kaixin001.activity
魅族商城|com.meizu.store
咚漫|com.naver.linewebtoon.cn
开卷有益|com.kingreader.framework.hd
中国国航|com.rytong.airchina
掌上NBA|net.joydao.nba.live
欢乐书客|com.kuangxiang.novel
极客学院|com.jikexueyuan.geekacademy
中国银行缤纷生活|com.forms
完美钢琴|com.gamestar.perfectpiano
快否|com.af.benchaf
开源中国|net.oschina.app
全局负一屏|com.example.xf.negativeonescreen.pro
Sony  Headphones Connect|com.sony.songpal.mdr
Nike Training Club|com.nike.ntc
电池校准|com.zhanhong.batterycalibration
二柄|com.diershoubing.erbing
X分身|com.godinsec.godinsec_private_space
上海交通卡|com.jiuyu.sptcc.cordova
音频工具箱|com.playwfd.avtools
网速指示器|com.coderchoy.netspeed
民萌|com.PhantomSix.animedb
爬小说|cc.aoeiuv020.panovel
优购时尚商城|com.yougou
漫画喵|com.manhuamiao.activity
海报工厂|com.meitu.poster
绿色音乐|com.yuanwofei.music
AVL Pro|com.antiy.avlpro
果壳相机|com.geak.camera
企鹅体育|com.tencent.tv.qie
货拉拉|com.lalamove.huolala.client
机核|me.tangke.gamecores
盖特|com.souget.get
广西移动和掌桂|com.sinovatech.gxmobile.ui
玩美相机|com.cyberlink.youperfect
世纪佳缘|com.jiayuan
MediBangPaint|com.medibang.android.paint.tablet
小寻书|com.hue.xiaofindbook
蝰蛇音效驱动挂载器|me.llun.v4amounter
See微博客户端|com.caij.see
左右手|com.liuyx.myblechat
果壳轻系统GEAK OS|com.geak.mobile
快速打开活动|com.zncm.dminter.mmhelper
Photoshop Mix图片融合|com.adobe.photoshopmix
阳光惠生活|com.ebank.creditcard
薄荷记账|melandru.lonicera
简UI V3(KLWP预设)|jui2017.kustom.wallpaper
CC归属地|zhs.betalee.ccarea
麦当劳优惠券完美版|wenhr.Mcdonalds
海尔洗衣|com.haier.uhome.washer
文件管理器|com.rhmsoft.fm
聚看影院|com.qymovie
小熊录屏|com.duapps.recorder
comico漫画|nhncomico.comico
星尘浏览器HD|com.chaozhuo.browser
石墨文档|chuxin.shimo.shimowendang
Opera Mini beta web browser|com.opera.mini.native.beta
孔夫子旧书网|com.kongfz.app
爱搜云|com.fanchen.aisou
Shizuku Manager|moe.shizuku.privileged.api
日语五十音|air.svran.nihongstudy
高级工具箱|com.zhanhong.tools
按键屏蔽|tool.xfy9326.keyblocker
通知通知|mark.notification
MindMaster思维导图|com.edrawsoft.mindmaster
相册管家-腾讯出品|com.tencent.gallerymanager
和我信|com.jx.cmcc.ict.ibelieve
QPython|com.hipipal.qpyplus
AppOpsX|com.zzzmode.appopsx
学堂在线|com.xuetangx.mobile
开发者头条|io.manong.developerdaily
Always On AMOLED|com.tomer.alwaysol
花椒直播|com.huajiao
天籁K歌|com.audiocn.kalaok
ZERO桌面|com.zeroteam.zerolauncher
华为穿戴|com.huawei.bone
dodol桌面 - 智能手机的“转变”项目|com.campmobile.launcher
21世纪的终端-NeoTerm|io.neoterm
隐私计算器 - Google Play评分4.7 & 100万+下载|com.hld.anzenbokusufake
一罐|club.jijigugu.yiguan
有调|com.diaox2.android
盘丝洞|com.psd
X-Flat图标包|com.wokee.xflat
新浪微博4G版|com.sina.weibog3
坂坂—萌化你的Android|com.banban.bbslite
王者人生|com.tencent.igame
阿里通信|alicom.palm.android
平安好医生|com.pingan.papd
北京一卡通|cn.com.bmac.nfc
万兴神拍手:PowerCam|powercam.activity
我爱足球|net.joydao.football.time
锦江酒店|com.plateno.botaoota
丰趣海淘|com.sfht.m
360天气|net.qihoo.launcher.widget.clockweather
Yogurt 酸奶盖图标包|com.modetime.yogurt
AA小说下载阅读器|com.aareader
灵梦|yyc.lm
大牛助手|com.deniu.multi
多点|com.wm.dmall
重庆移动|com.cqmc.client
趣满满|com.coolsoft.movie
元贝驾考|com.runbey.ybjk
小蚁摄像机|com.ants360.yicamera
雅虎邮箱:Yahoo Mail|com.yahoo.mobile.client.android.mail
高效Todo|net.icycloud.fdtodolist
体检宝测血压视力心率|comm.cchong.BloodAssistant
Root工具箱|com.superthomaslab.rootessentials
易码－私人云笔记|me.tshine.easymark
观止|com.meiriyiwen.app
天翼云盘|com.cn21.ecloud
掌厨|com.gold.palm.kitchen
GO联系人|com.jbapps.contactpro
和包支付|com.cmcc.hebao
东方航空|com.rytong.ceair
ViaNext 浏览器|mark.via.z
中粮我买网|com.womai
一起小学学生|com.A17zuoye.mobile.homework
二手车之家|com.autohome.usedcar
集享联盟|com.maxxipoint.android
Candy电话|com.candykk.android.dialer
1药网|com.yiwang
魔力盒|com.movier.magicbox
轻息屏|com.pw.screenclicker
虎嗅|com.huxiu
Sleep Better|com.runtastic.android.sleepbetter.lite
悬浮助手:RelaxFinger|com.hardwork.fg607.relaxfinger
沪江网校|com.hujiang.hjclass
360智能摄像机|com.qihoo.camera
小蚁运动相机|com.xiaomi.xy.sportscamera
MOO音乐|com.tencent.blackkey
分身大师|com.qihoo.magic_mutiple
火萤组件|com.znxh.hyengine
熊猫看书|com.nd.android.pandareader
半糖|com.jzyd.BanTang
ZenUI 桌面|com.asus.launcher
存储卡管理器|com.sandisk.mz
词根词缀记忆字典|com.ghosun.dict
轻课表|com.ruby.timetable
拼图酱|us.pinguo.april_collage
FilterGrid|com.rcplatform.filtergrid
原力囚徒健身|ren.qiutu.app
MIUI助手|com.kdfly.miuihelper
八闽生活|qzyd.speed.nethelper
SegmentFault|com.segmentfault.app
每日优鲜|cn.missfresh.application
两步路户外助手|com.lolaage.tbulu.tools
3个目标 - 最美习惯打卡|com.eve.habit
普通话测试|com.huahua.testing
在意空气|com.freshideas.airindex
减肥小秘书|COM.Bangso.FitMiss
启信宝-企业信用查询|com.bertadata.qxb
趣店|com.qufenqi.android.app
马甲线|cn.pocdoc.majiaxian
妈妈帮|com.yaya.mmbang
眼缘|com.yanyuan.xiaojie
照片保险箱|com.thinkyeah.galleryvault
游戏时光|com.bard.vgtime
Power Battery﹣省电优化、延长电池电量、加速充电|com.lionmobi.battery
超星移动图书馆|com.superlib
校园助手|cn.nicolite.huthelper
乐心运动|gz.lifesense.weidong
CC来电拦截|zhs.betalee.ccCallBlocker
小米白噪音|com.miui.whitenoise
VIPERFX--XDA代理开发版-不欢迎安智网的“一个人的冬季”|com.pittvandewitt.viperfx
PDF Reader|com.kdanmobile.android.pdfreader.google.pad
首汽约车|com.ichinait.gbpassenger
Firefox Focus|org.mozilla.focus
LOL动态壁纸:Live Wallpapers of LoL|com.sysoft.lollivewallpapers
猫眼专业版|com.sankuai.moviepro
SwitchNFC|com.wokee.switchnfc
欢欢浏览器 -- 视频嗅探、快进视频广告|com.happy.browser
羽翼图标包|com.jeromeshaw.iconpack.flugilo
同花顺爱基金(银行理财)|com.hexin.android.bank
塔读文学|com.tadu.android
味库美食视频|cn.wecook.app
超级火车票|com.kuxun.scliang.huoche
角虫绘图|com.energysh.drawshow
GameBench|com.gamebench.metricscollector
中国国家地理|com.dili360
图片合成器|cn.poco.pMix
Galet 图标包|com.clydeshenry.iconpack.galet
扇贝读书|com.shanbay.reader
阿里智能|com.aliyun.alink
超卓文本编辑器|com.chaozhuo.texteditor
剪纸堆 Clip Stack|com.catchingnow.tinyclipboardmanager
黑加|com.ryeex.groot
录屏助手·重制版（免ROOT高清录屏）|com.video
索尼精选HiRes音乐|com.hiresmusic
美图看看|com.meitu.kankan
掌上看家|com.ichano.athome.camera
酷讯机票|com.kuxun.scliang.plane
广东天翼|com.gdctl0000
片刻|com.pianke.client
蔚蓝地图|com.environmentpollution.activity
安兔兔验机|com.uzywpq.cqlzahm
作文纸条|zwzt.fangqiu.edu.com.zwzt
塔词 - 桌面背单词|com.myderta.study.dertastudy
空间回收|com.mh.appclean
LED显示屏|com.eleven.app.ledscreen
有道精品课|com.youdao.course
505天气|com.lha.weather
锤子科技论坛|com.smartisan.bbs
TeamViewer QuickSupport|com.teamviewer.quicksupport.market
汇金|com.adc.huijin
好多动漫|com.east2d.everyimage
表情工厂|com.meitu.facefactory
镜像工厂|crixec.app.imagefactory
美味不用等|com.puscene.client
Agoda安可达|com.agoda.mobile.consumer
滴滴司机-出租车版|com.sdu.didi.gui
随便走|cn.gogocity.suibian
小木虫|com.zhuanyejun.club
Ami相册|com.gionee.freya.gallery
鬼畜输入法|com.blinnnk.zeus
LOFTCam|com.netease.loftercam.activity
股吧|com.eastmoney.android.gubaproj
微软小冰|com.microsoft.xiaoice
AppSo|com.ifanr.appso
南瓜电影|cn.vcinema.cinema
百万壁纸|com.miui.coolwallpaper
口袋记账|com.qeeniao.mobile.kdjz
背景散焦|com.sonymobile.backgrounddefocus
好看视频|com.baidu.haokan
CPU设置|com.zhanhong.cpusettings
小米电台|com.miui.fmradio
Mark|com.intlime.mark
小蓝单车|com.beastbike.bluegogo
氡·OpenGApps|com.jakting.opengapps
MusicPlayer|ironbear775.com.musicplayer
EmptyCleaner|com.genius.emptycleaner
飞凡|com.wanda.app.wanhui
华硕日历:ASUS Calendar|com.asus.calendar
ARCore|com.google.ar.core
Font Studio|com.rcplatform.fontphoto
ADB工具安装器|crixec.adbtoolkitsinstall
人人车二手车|com.renrenche.carapp
小伴龙|com.xiaobanlong.main
小爱同学|com.xiaomi.xiaoailite
净化大师国际版:Kingroot Purify|com.kingstudio.purify
思维导图|czh.mindnode
喵特|com.nyato.client
必要|com.biyao.fu
CC直播|com.netease.cc
图痒|com.tutao.picyoung
给未来写封信 - 时光邮局|com.kongzue.tofuture
FT中文网|com.ft
手机加速器（系统优化大师）|com.fractalist.MobileAcceleration
EverMemo|com.zhan_dui.evermemo
屏幕旋转|personal.fameit.nl
扇贝口语|com.shanbay.speak
清清理|com.mh.cleantoo
PICOOC|com.picooc
转移到 iOS|com.apple.movetoios
一加录音机|com.oneplus.soundrecorder
喵呜颜文字|com.hodanet.yanwenzi
粤语U学院|com.huahua.yueyu
NFC模拟器|com.wrbug.nfcemulator
普通话学习|com.huahua.learningpth
Unicode|com.by_syk.unicode
百度帐号管家|com.baidu.passport.securitycenter
英语趣配音|com.ishowedu.peiyin
猎豹锁屏大师|com.cmcm.locker
3DBody|com.HaoTuBang.H3DBodyFree
埋堆堆|com.tvbc.maiduidui
香哈菜谱|com.xiangha
OpenHub for GitHub|com.thirtydegreesray.openhub
鹏淘|com.uniriho.szt
尺子|com.ruler.csw
Tinted Statusbar-Substratum主题|cn.luojuly.tinted
钛媒体|com.businessvalue.android.app
Garmin Connect Mobile|com.garmin.android.apps.connectmobile
涂书笔记|com.baidu.notes
沪江听力酷|com.hj.dictation
开源课程表|cc.metapro.openct
CPU-Z中文版|com.seekyousoft.app.cpuinfo
乐蜂网|com.yek.lafaso
全能计算器|com.jincheng.supercaculator
nubia社区|cn.nubia.bbs
斗图神器|com.doutu.www
美篇|com.lanjingren.ivwen
麦当劳官方手机订餐APP|com.mcdonalds.gma.cn
淘宝特价版|com.taobao.litetao
WI输入法|com.hit.wi
春雨计步器|me.chunyu.Pedometer
DJIGO4|dji.go.v4
酷查|com.coolapk.searchbox
亲子相机|cn.poco.BabyCamera
辣妈帮|com.wangzhi.MaMaHelp
看应用|com.linroid.viewit
Y2002电音|com.blueocean.musicplayer
智学网|com.iflytek.elpmobile.smartlearning
Zine|com.auramarker.zine
Flow|com.drediki.flow
Nico|com.superrhino.rarering
古诗文网|org.gushiwen.gushiwen
TripAdvisor猫途鹰|com.tripadvisor.tripadvisor.daodao
微软 Hyperlapse 移动版|com.microsoft.hyperlapsemobile
一加卡券|com.oneplus.card
日本の伝統色|com.Delsart.color
微桌面（智能语音主题壁纸美化锁屏）|com.tencent.qlauncher.lite
全局透明屏幕|com.jian.touming
腾讯微博HD|com.tencent.microblog
驴妈妈旅游-门票.酒店.自由行.团购|com.gift.android
微米浏览器|com.ume.browser
备份助手|cuuca.sendfiles.Activity
一嗨租车|com.ehai
搜狗搜索|com.sogou.activity.src
SNKRS|com.nike.snkrs
洋葱数学|com.yangcong345.android.phone
猫扑|com.mop.activity
iTime|com.example.countdown
小Q画笔|com.tencent.qpaint
宜停车|com.szchmtech.parkingfee
贝壳单词|me.drakeet.seashell
配音秀|com.happyteam.dubbingshow
DJIGO|dji.pilot
【停更】LP图标包 评论区传送门|com.LP.iconpack
吃掉内存|cn.as.eat
云南移动手机营业厅|com.ailk.ech.woxin
LP图标包 - 第一夫人|com.lycsky.laopo.iconpack
一席|com.taguxdesign.yixi
Finger|com.tuotuo.solo
华硕天气|com.asus.weathertime
C5GAME|com.imbastar.c5game
芝士超人|com.inke.trivia
微爱|com.welove520.welove
阿里TV助手|com.yunos.tvhelper
彩云小译|com.caiyuninterpreter.activity
华硕文件管理器|com.asus.filemanager
新机表|app.xunxun.homeclock
Opera Max|com.opera.max.global
违章查询助手|com.autohome.mycar
Anki划词助手|com.mmjang.ankihelper
百词斩词典|com.baicizhan.dict
出门问问|com.mobvoi.baiding
Ansole 终端|com.romide.terminal
高级重启|com.buxsren.reboot
索尼时钟小部件|com.sonymobile.advancedwidget.clock
我的iPhone X|yzdcode.com.iphonex
动动计步器|com.mandian.android.dongdong
火龙果图标包 Pitaya IconPack|com.pitaya.iconpack
小鹿情感先生|com.mei.melkor
teambition|com.teambition.teambition
斗鱼极速版|com.douyu.rush
购物党|com.gwdang.app
安卓桌面|com.nd.android.smarthome
优酷VR|com.youku.vr.lite
乐桌面HD|com.lenovo.launcherhdmarket
Opera browser|com.opera.android.browser
MOJi辞書: 实用日语词典「日本旅游  学日语翻译必备」|com.mojitec.mojidict
快对作业|com.kuaiduizuoye.scan
有道语文达人|com.youdao.hanyu
极加速|com.gto.zero.zboost
BambooPlayer|gov.anzong.mediaplayer
Moto相机|com.motorola.cameraone
APUS手电筒|com.apusapps.tools.flashtorch
C语言学习宝典|com.chenghui.study.c
百度极速版|com.baidu.searchbox.lite
QQ浏览器极速版|com.tencent.mtt.lt
妙笔生花:SketchBook for Galaxy|com.adsk.sketchbookhd.galaxy.oem
Candy短信|com.candykk.android.messaging
印记云笔记|com.anybeen.mark.app
咕咕漫画|com.eonsun.lzmanga
圆周率性能测试|com.xyznh.yzlc
DJ多多|com.shoujiduoduo.dj
ANT桌面:ANTLauncher|com.ant.launcher
小米一键换机|com.miui.backup.transfer
手工客|com.wowsai.crafter4Android
短信伪造器|com.zhanhong.message
Wolfie for KWGT|wolfieforkwgt.kustom.pack
Raven图标包|com.raven.iconpack
百度地图XL版|com.baidu.MapBaidu
噜咖VR播放器|com.rockvr.moonplayer_gvr
华夏银行|com.rytong.app.bankhx
阅读星Pro|com.person.reader
小红伞安全|com.avira.android
Mathlab计算器|us.mathlab.android
杉果游戏|com.sonkwoapp
证件照随拍|com.piaopiao.idphoto
蚂蚁浏览器|org.mozilla.fennec_mylinux
视频头条|com.yunfan.topvideo
QPython 3|com.hipipal.qpy3
新浪财经|cn.com.sina.finance
NoShadow图标包|com.tseng.iconpack.design
Cutie|com.funny.cutie
VEditor - 视频音频反转、视频剪辑转Gif|gdut.bsx.videoreverser
云脉文档识别|hotcard.doc.reader
艺龙酒店|com.elong.hotel.ui
指南针|com.androlua.compass
开小号|com.cmcm.multiaccount
公众号音频下载|com.playwfd.mpaudio
华硕浏览器:ASUS Browser|com.asus.browser
免费文字转语音|com.example.wenyu
爽哥英语|air.com.shuangge.phone.ShuangEnglish
儿歌多多|com.duoduo.child.story
通知栏Home键:My Home Button|wq.myhomebutton
LoveLive桌面|com.lkyear.lllauncher
毒舌电影|com.dushe.movie
账单助手-简洁记账|com.suda.jzapp
小米移动|com.xiaomi.mimobile
弹弹Play|cn.swt.danmuplayer
萝卜书摘|com.bloomlife.luobo
MUTA音乐|com.muta.yanxi
火柴盒|cc.huochaihe.app
MAKA|com.maka.app
WiFi View|com.zzz.wifiview
必看-优选日剧美剧国产剧番剧电影|com.tencent.txentertainment
A屏动态壁纸|com.maxelus.livewallpaper.amoled
猎豹备份大师|com.ijinshan.kbackup
Uplay|com.ubisoft.uplay
IKEA|com.ikea.kompis
导航栏开关(需要Root,实测MIUI开启后会有全面屏手势)|com.NavigationBarSwitch
视频转换器|com.xvideostudio.videocompress
没得比|com.meidebi.app
搜狗输入法OPPO版|com.sohu.inputmethod.sogouoem
line xperia主题|com.yourcompanyname.line
小购物|io.github.gtf.easyShopping
菁优网|jyeoo.app.ystudy
小米音箱|com.xiaomi.mico
熊猫出行|com.futurefleet.pandabus.ui
头像大师|com.babycloud.headportrait
小日常|com.android.yzd.habit
小猪|com.xiaozhu.xzdz
播客管理AntennaPod|de.danoeh.antennapod
水印|com.test.onepluswatermark
加油广东|com.sunboxsoft.oilforgdandroid
Zone指南针|com.mixiaoxiao.ioscompass
和讯财经|com.hexun.news
句读|tech.caicheng.judourili
八爪鱼手游大师|com.chaozhuo.gameassistant
宜家家居指南|com.ikea.catalogue.android
验证码复制|chenmc.sms.code.helper
MD配色参考|com.by_syk.mdcolor
Apowersoft录屏王|com.apowersoft.screenrecord
猿辅导|com.yuantiku.tutor
腾达路由|com.tenda.router.app
小米字体修改:Mi Font Maker (FontToMtz)|com.htetznaing.miuifontmaker
轻听英语|cn.com.langeasy.EasyListen
壁虎照片恢复|mobi.bihu.recovery.photo
一键锁屏|mark.lockscreen
腾讯NOW直播-附近美女真人视频聊天|com.tencent.now
UC头条|com.uc.infoflow
InstaSize|com.jsdev.instasize
在行一点|com.guokr.fanta
淘粉吧-网购返集分宝|com.leixun.taofen8
新车评|com.xincheping.xincheping
圈子账本记账理财|com.account.book.quanzi
周末去哪儿|com.xisue.zhoumo
智远一户通|com.cmschina.stock
春秋航空|com.china3s.android
随手记账|com.caiyi.accounting.ss
小京鱼|com.jd.smart
WITNESS 图标包|com.ken.nanoiconpack.witness
声波清理大师|com.mida.soundtools
百度CarLife|com.baidu.carlife
爱奇艺VR|com.iqiyi.ivrcinema.cb
茄子换机|com.lenovo.anyshare.cloneit
TigerTrade老虎证券|com.tigerbrokers.stock
畅途汽车票|com.tts.hybird
自冻(FreezeYou!) - 冻结加速计划|cf.playhi.freezeyou
环球时报|com.huanqiu.news
量子清理加速-清理大师助手|com.shere.easycleaner
书香小说|com.ireadercity
CAD派客云图|com.ZWSoft.ZWCAD
密码键盘 - 优雅的密码管理器|com.kongzue.secretinput
12580|cn.com.umessage.client12580
表情包生成器|com.android.emoticoncreater
睡你妹闹钟|droom.sleepIfUCan
一卡通充值|com.dodopal.android.client
Pure H2O-Substratum主题|com.qinghuan.pure.h2o
民生信用卡全民生活|com.cmbc.cc.mbank
网速悬浮窗|com.acker.speedshow
剪码涂|bos.consoar.photoeditor
Sherlock手机锁定|com.wocao.sherlock
智能优化 - SmileSoft|com.smile.optimize
哆点|com.drcom.DuoDian
微软锁屏|com.bing.lockscreen
表情王国|com.xtone.emojikingdom
流量盒子|com.zyc.flowbox
One Plus Screen|com.dede.oneplusscreen
微医|com.greenline.guahao
朗易思听|cn.com.langeasy.LangEasyLrc
Armorfly浏览器|com.cmcm.armorfly
丁香智汇|cn.dxy.medtime
典典养车|com.chediandian.customer
掌上飞车|com.tencent.gamehelper.speed
阿基米德|org.ajmd
简洁记账|com.yu.keepaccounts
华硕时钟|com.asus.deskclock
轻芒通知清理|com.wandoujia.notification
爱回收|aihuishou.aihuishouapp
搞机工坊—刷机助手资源工具|com.XuanWu.gaojigongfang
锤子邮件|com.smartisan.email
Fit健身|com.sportq.fit
蝉游记|com.chanyouji.android
贝阅|me.zheteng.cbreader.beiyue
美团众包|com.sankuai.meituan.dispatch.crowdsource
埃微助手|com.kunekt.healthy
QQ聊天记录导出|top.drawcore.mqme
Bar图标包|com.bar.iconpack
化学方程式|com.zzu.sxm.chemical
如故|com.roogooapp.im
浙江联通|uni.jdxt.app
一账通|com.pingan.yzt
UtoVR|com.jietusoft.utovr
Pure Oreo - Substratum主题|cn.lirui.pure.oreo
虎扑跑步|com.hupu.joggers
forlm图标包|com.forlm.iconpack
天猫精灵|com.alibaba.ailabs.tg
爱音乐|com.gwsoft.imusic.controller
行程助手|com.qyer.android.plan
Lim浏览器|com.iacn.limbrowser
偷拍相机|com.xchat.stevenzack.spycamera
积目|com.fenzotech.jimu
百度传课|com.chuanke.ikk
NONo笔记|com.seki.noteasklite
杜亮的LED手电筒|com.dianxinos.flashlight.duplay
音量管家|com.volume.manager
途家 - 公寓预订|com.tujia.hotel
男友力平台|com.xiandanjia.android
乐蛙桌面|com.lewaos.launcher
方正字酷(字体随心换)|com.founder.font.ui
随芯用|com.ccb.atms.mobilepay_forsd
土巴兔装修|com.to8to.housekeeper
网易电影|com.netease.movie
存储重定向 - 应用存储空间隔离|moe.shizuku.redirectstorage
富途牛牛港股美股|cn.futu.trader
Firefox Nightly 开发者版|org.mozilla.fennec_aurora
GirlsCam|com.wecut.lolicam
贝瓦儿歌儿童早教|com.slanissue.apps.mobile.erge
Feel|com.zhiyun.feel
爱动漫|com.erdo.android.FJDXCartoon
图酷相册（快快图^.^）|com.augustus.piccool
平安证券|com.hundsun.winner.pazq
酷派日历|com.yulong.android.calendar
ofo摩拜优惠码|com.alijava.bike
一知|com.android.app.notificationbar
彩蛋视频壁纸|com.novv.resshare
大同词典-超好用的英语、日语词典|com.datong.dict
阿凡题|com.lejent.zuoyeshenqi.afanti
KSWEB开源服务器|ru.kslabs.ksweb
镧·电磁炉|com.xzr.La.hotter
玩科技|wan.ke.ji
360儿童卫士|com.qihoo360.antilostwatch
榴莲|com.baidu.image
富友收件宝|com.fuiou.mgr
天天|me.i38.dayday
万能影视|com.wnys.video
验证码复制器|rikka.smscodehelper
和飞信|com.chinasofti.rcs
站酷客户端|com.zcool.community
Soap|com.zhao.launcherlite
锤子风图标包|com.sm.iconpack
Anitama|cn.anitama.tamako
IPHunter|com.z.adbshellcommand
X脚本Xscript|com.surcumference.xscript
习惯|org.isoron.uhabits
华硕图库|com.asus.gallery
三星个性化面板|com.personalization.parts
硬派健身|com.toughwo
导航栏开关|psj.servicesample
Mouse 翻译|com.example.jooff.shuyi
YY手游语音|com.duowan.gamevoice
屏幕时钟|com.by_syk.screenclock
Tipix|com.iafun.Tipix
闪电视频|com.chaojishipin.lightningvideo
个人图书馆|com.doc360.client
A9VG|com.wanmei.a9vg
火猴浏览器|com.huohoubrowser
卷皮-9.9包邮|com.xiudang.jiukuaiyou.ui
一加圆形图标包:Round Icon Pack|com.oneplus.iconpack.circle
Amazfit手表|com.huami.watch.hmwatchmanager
轻快递|com.sendtion.kuaidi
云脉（思根）拍照翻译|hotcard.net
心动|com.maxiee.heartbeat
河图-岁寒输入法|com.suihan.version4
速递易|cn.sudiyi.app.client
单读|com.onewaystreet.weread
同文输入法|com.osfans.trime
虎扑足球|com.hupu.football
大角虫漫画|cn.kidstone.cartoon
译学馆|com.huaer.mooc
德语助手|com.eusoft.dehelper
MIUI运行模式|com.BlackTeaChan.MIUIRunMode
HiroMacro按键录制|com.prohiro.macro
51CTO学院|com.cto51.student
财新|com.caing.news
MyerSplash Wallpaper|com.juniperphoton.myersplash
玩加电竞|com.wanplus.wp
平行世界|com.llspace.pupu
火辣健身|com.hotbody.fitzero
我的天气|com.clover.myweather
华硕计算器|com.asus.calculator
美居|com.midea.ai.appliances
HandShaker|com.smartisanos.smartfolder.aoa
遥控大师|com.suncamctrl.live
少数派|com.sspai.sspaiandroid
食物派|com.boohee.food
云之家|com.kdweibo.client
木瓜|com.lanyuan.picking
HP照片打印|com.hp.android.print
全国汽车票|com.wxws.myticket
拉卡拉收款宝|com.lakala.shoudan
魅族换机助手|com.meizu.datamigration
星尘浏览器平板x86版|com.chaozhuo.browser.x86
腰果公考|com.appublisher.quizbank
NHK简明日语|me.visencl.app.easyjapanese
关闭SELinux|com.woc.offselinux
微历|im.ecloud.ecalendar
网易云阅读 for Pad|com.netease.pris.hd
魅族读书|com.meizu.media.ebook
万门大学|org.wanmen.wanmenuni
漫漫漫画|com.itcode.reader
日语学习|com.zhiyong.japanese.word
MIUI9图标包|com.free.miui9.iconpack
沃·行讯通|xxt.com.cn.ui
e代驾|cn.edaijia.android.client
IntelSupportApp|com.intel.ark
小米VR|com.mi.dlabs.vr.hulk
[ROOT] Smart Lock 启动器 - Smart Lock 设置快捷方式|net.rachel030219.smartlocklauncher
央视新闻|cn.cntvnews
单纯的是个图片小部件|top.soyask.schedulei
随身书包|tools.yiclear.com.book
BT搜索|com.taisenjay.p2psearcher
Valerie [Substratum]|com.samsoft.valerie
360安全换机|com.qihoo360.transfer
小站托福|com.zhan.toefltom
有道e读|com.youdao.sw
三星健康步数管理|com.samsung.android.app.health.dataviewer
增强输入 Inputting+|com.catchingnow.undo
氧气听书|com.anysoft.tyyd
单纯的就是个日历|top.soyask.calendarii
相片大师|com.cyberlink.photodirector
快科技|com.kkeji.news.client
手机字体安装器|com.jrummy.font.installer
小日常|com.dandelion.routine
优信二手车|com.uxin.usedcar
纸草笔记本|com.steadfastinnovation.android.projectpapyrus
喵时钟|com.glgjing.baymax
英语四级君|com.duia.cet4
涂手|cn.lifefun.toshow
边缘任务Speed（全面手势）|com.gesture.s.speed
古诗文|app.errang.com.poems
中华英才网|com.chinahr.android.m
波洞-看漫画动漫社区|com.tencent.nijigen
手机知网|com.cnki.client
金山背单词|com.kingsoft.wordback
NBA APP-NBA中国官方应用|com.tencent.nbagametime
Wecut|com.hithway.wecut
模拟炒股|com.winner.simulatetrade
游品位|com.netease.gamecenter
锁屏大师|com.ztapps.lockermaster
lativ诚衣|com.lativ.shopping
TVShow Time|com.tozelabs.tvshowtime
Start锁屏|com.celltick.lockscreen
MaterialUp|org.goodev.material
有道四六级|com.youdao.cet
英语消消乐|com.melostudio.wordcrush
华硕Remote Link|com.asus.remotelink.full
逛丢|com.guangdiu.guangdiu
微软登录验证:Microsoft Authenticator|com.azure.authenticator
GcmForMojo|com.swjtu.gcmformojo
健康160预约挂号咨询平台|cn.kidyn.qdmedical160
Cutisan - 壁纸精选与制作|com.imuuzi.cutisan
加油宝|com.jtjr99.jiayoubao
Coding|net.coding.program
魔力高清影视|com.molivideo.android
乐云记事|com.lenovo.supernote
程序员计算器|com.example.calculatorforprogrammer
英语广播|com.xiaobin.voaenglish
去你妈的温控|com.meniao.temperature_control
永辉全球购|cn.com.yonghui
图鉴探索版 Tujian R-精选壁纸推荐|ml.cerasus.pics.g
阿里众包|com.taobao.newjob
乐语音|com.lenovo.menu_assistant
北京交警|com.zcbl.bjjj_driving
方片收集|com.quickwis.funpin
一键锁屏 - Looock|com.zerosimple.looock
小鸣单车|com.xiaoming.bike
MOZIK|com.datech.mozik
书法字典大全|com.zivn.cloudbrush3
新东方在线|com.koolearn.android
天气预报|com.txj.weather.anmei
掌心管家|com.zte.heartyservice
逗拍|com.dou_pai.DouPai
GIF制作器|com.youxianwubian.gifzzq
悬浮侧边栏|com.ksxkq.floatside
华硕随手记:Quick Memo|com.asus.quickmemo
my3T|djwdj.my3T
天巡旅行|com.tianxun.android.zh
酷桌面|app.cobo.launcher
MSN天气|com.microsoft.amp.apps.bingweather
JY Share 更好的分享应用|com.janyo.janyoshare
好分数|com.yunxiao.haofenshu
58到家|com.wuba.jiazheng
A屏壁纸|com.aneeshpradeep.amoledwallpaper
飞客茶馆|com.ideal.flyerteacafes
Feeder（RSS 阅读器）|me.zsr.feeder
兴趣部落|com.tencent.tribe
每日瑜伽|com.dailyyoga.cn
饭局狼人|com.mewe.wolf
Score|com.famulei.famulei
通知增强 for 微信|me.zhanghai.android.wechatnotificationtweaks2
瑞星手机安全助手|project.rising
可萌记账|net.ffrj.pinkwallet
美团开店宝|com.sankuai.meituan.merchant
Wechat Black Mod-Substratum主题|com.qinghuan.wechat.black
好乐买|com.okbuy.activity
智能状态栏|com.pw.smartbar
Music Center(SongPal)|com.sony.songpal
全球学术快报|com.cnki.android.cnkimobile
51公积金管家|com.balance6game.housingfund
CIDE|org.free.cide
你的手机助手|com.microsoft.appmanager
Shortcuts App|com.zhihaofans.shortcutapp
句子迷|com.example.juzimi
极度清理专业版|com.wrste.qli
一加管理|com.mockingjay.onepluscontrol
腾讯文档|com.tencent.docs
Apktool+助手|FormatFa.ApktoolHelper
国漫|com.qingman.comic
铜板街|com.tongbanjie.android
兜兜公交|com.teewoo.app.bus
完美志愿|com.gaokaozhiyuan
好物|com.tellswell.lecigou
10000社区|dxwt.questionnaire.ui
轻时钟|com.xyznh.blackclock
微软笔记Parchi|com.microsoft.bites
华硕微电影|com.asus.microfilm
Mind-提高专注度|com.w.schulte
实习僧|com.shixiseng.activity
法语助手|com.eusoft.frhelper
酷安灵魂手绘|com.coolapk.iconpack.hand_drawing
黑暗计算器(复数，解方程)|com.sf.DarkCalculator
ApowerMirror|com.apowersoft.mirror
翻片|com.mp.fanpian
叨鱼|com.sdo.sdaccountkey
Timing|com.huiian.timing
一览阅读|com.hl.matrix
赤兔|com.linkedin.chitu
每日故宫|com.lkgood.thepalacemuseumdaily
高考蜂背|com.zhouyue.Bee
乐视VR|com.lemi.lvr.superlvr
单词日记|com.wordaily
海通e海通财|com.android.haitong
虚拟按键大师|com.jjapp.quicktouch.inland
奇酷社区|com.qiku.bbs
墨池书法|com.mingzhihuatong.muochi
Microsoft 帐户:Microsoft account|com.microsoft.msa.authenticator
高考妙记|com.toastmemo
miku深海少女 - xperia主题|com.xiaoxiaomo.miku.xperia
GEAK Compass|com.geak.compass
客运12308|com.tieyou.bus.ark
公务员考试|com.up591.android
黑岩阅读|com.heiyan.reader
益动GPS|com.edooon.gps
奕报告|com.lysoft.android.lyyd.report
Party Star图标包|com.paidax.iconpack.partystar
Groove|com.microsoft.xboxmusic
免费吉他谱|com.buluobang.bangtabs
弹幕通知|com.Delsart.NofiCatch
CM Speed Booster|com.cleanmaster.boost
指尖轻舞桌面:Slide On Desk|com.djun.SlideOnDesk
百度云企业版|com.baidu.cloudenterprise
北京银行“京彩生活”手机银行|com.rytong.bankbj
倒班助手|com.shougang.shiftassistant
画图|com.qingsong.drawing
幻音音乐|com.huanyin.magic
H&M|com.hm.goe
.nomedia|ooo.oxo.apps.nomedia
绿乐|com.yuanwofei.greenmusic
2345天气预报|com.tianqi2345
通知栏锁屏:My Lock Screen|wq.mylockscreen
英语读书|com.tataera.edushu
猴子播放器|com.sunjiajia.player
沃TV|com.unicom.wotv
掌上基金|howbuy.android.palmfund
知米听力|cn.edu.zjicm.listen
S1官方移动客户端|com.stage1st.app
华硕录音机|com.asus.soundrecorder
名片全能王企业版|com.intsig.camcard.enterprise
机器人EVA（微信撤回查看）|robot14.revoke.deified.com.donotrevoke
Adobe图形:Adobe Shape|com.adobe.creativeapps.shape
乐学高考志愿|com.lexue.zhiyuan
SD卡高级清理|com.ktls.scandandclear
假装熄屏|com.zzapp.turnonyouscreen
上海迪士尼度假区|com.disney.shanghaidisneyland_goo
GoPro|com.gopro.smarty
超级加速|com.apusapps.tools.booster
来了老弟|com.haishi.laodi
AndroLua+|com.androlua
隐私空间|com.leo.appmaster
氢OS 8.0+专用substratum主题|sulisong.theme.h2os
饿了么商家版|me.ele.napos
Biu视频桌面|com.yy.bivideowallpaper
M ONE  一个客户端|com.orekie.mone
一号专车|com.duoduo.passenger
5X兴趣社区|com.xxxxxbbs.spark
鹅说|com.atonce.goosetalk
大家中医|com.dajiazhongyi.dajia
开心斗：桌面小游戏|com.duowan.makefriends
一招|com.gongfu.onehit
水墨屏|com.electronicink.jrsen
淘优惠-淘宝优惠券插件|com.oceanzhang.mediarender
美食天下|com.jingdian.tianxiameishi.android
189邮箱-短信/云/语音/文件/通讯录|com.corp21cn.mail189
弹琴吧|com.tan8
英语魔方秀|com.memory.me
心理FM|com.xinli.fm
起点小说|com.qidian.QDReader.cps
资费管家|cn.com.tc.assistant
壹心理|com.xinli.yixinli
索尼xperia主题|com.yourcompanyname.sonyf
WiFi测评大师|com.wmos.main
最美创意|com.bugkr.beautyidea
ViPER4Android XHiFi 音效驱动 v2.1.0.2|com.vipercn.viper4android.xhifi
cnBeta Plus|com.ywwxhz.cnbetareader
十六番|com.fan.app
2d性能测试|com.yyc.twod
Android工具箱|com.ydejia.com.dandan
恋爱记|com.lianaibiji.dev
Do It Later|com.asus.task
陪你|com.zhao.withu
写字先生|com.font
唐僧英语|com.xingyuanma.tangsengenglish
订阅号助手|com.tencent.mp
SketchBook Express|com.adsk.sketchbookhdexpress
重启砖家|l.c
mars|com.yohobuy.mars
和讯股票（股票行情、股票查询、手机炒股）|com.hexun.mobile
Notepad|com.farmerbb.notepad
UC浏览器福利版|com.ucmobile.lite
有鱼记账|com.jz.youyu
时钟|com.frank.myclock
短信转发助手|com.example.qyoungde.smsforwarding
Kika Keyboard 键盘|com.qisiemoji.inputmethod
智商测试|com.example.li.iqchecked
完美备份|com.anshouji.perfectbackup
飞牛网-大润发网上商城|com.feiniu.market
微动手势|me.i38.gesture
XOutOf10|com.idoideas.xoutof10
时间胶囊|com.dante.diary
永乐票务|com.ylpw.ticketapp
面板顶栏美化主题-初音未来|com.lingweiliang.miku.zero
中国蓝TV|com.chinablue.tv
诗词中国|com.founder.poetry
应用卸载器|com.zhanhong.uninstall
Network Master|com.lionmobi.netmaster
课程表|com.strivexj.timetable
Plex播放器|com.plexapp.android
bong|cn.ginshell.bong
Nevolution|com.oasisfeng.nevo
时间天气桌面小部件|com.motorola.timeweatherwidget
速知天气|top.maweihao.weather
万兴影音|com.wondershare.player
2345手机浏览器|com.browser2345
通达信|com.tdx.AndroidNew
SketchBook Ink|com.adsk.sketchbookink_gen
三目VR|com.samonkey.samworld
摄取搜索|com.kunbo.search
巴塞电影|com.lfst.qiyu
光能手电筒|com.haishi.flashlight
VR视频|com.vr.video
Mobizen|com.rsupport.mvagent
企业QQ|com.tencent.eim
良仓|com.liangcang
Navigate-Substratum主题|cn.luojuly.Navigate
应用双开|com.baidu.multiaccount
墨迹天气极速版|com.moji.mjweather.light
CIBN高清影视|com.cibn.tv
Candy通讯录|com.candykk.contacts
超星泛雅|com.chaoxing.fanya.aphone
华硕手电筒|com.asus.flashlight
旗鱼影视|com.qiyu.film
Ami天气|com.gionee.amiweather
新华字典|cn.dictcn.android.digitize.swg_xhzd_21003
CC来电拦截N+|zhs.betale.ccCallBlockerN
记事本|com.zoho.notebook
东家|cc.kaipao.dongjia
江苏银行|cn.jsb.china
财经杂志|com.caijing
花哪儿记账 - 极简高效|com.kongzue.paywhere
生理期记录助手Clue|com.clue.android
过日子|com.huofar
在行|com.guokr.mentor
道客阅读|com.doc88.reader
词管家-简单高效记单词|com.zhangword.zz
FloatText (悬浮文本)|tool.xfy9326.floattext
寺库奢侈品|com.secoo
海航通信|com.tydic.app.hh
搜狐视频HD-电影电视剧|com.sohu.tv
开发助手|cn.trinea.android.developertools
会议投影|cn.nubia.wfd
悠播|com.um.mplayer
一句话桌面小提示|me.gfuil.hint
简笔|com.chenupt.text
葫芦时刻|com.qikan.dy.lydingyue
VR看片王|com.vrvrsee
sPlayer|com.sappx.splayer
muse|com.zhiliaoapp.musically
Bamboo Paper|com.wacom.bamboopapertab
闪电购便利店|com.redcat.shandiangou
深圳航空|com.air.sz
酷翻译|com.zjp.translation
心潮减压|com.heartide.xinchao.stressandroid
不可能的世界|com.kana.reader
360搜索|com.qihoo.haosou
杭州公交|com.dtdream.publictransit
有道背单词|com.youdao.reciteword
钱付后记|com.weige.mark
思维导图|dym.unique.mindmap
爱拍--火爆视频社区|com.aipai.android
最美时光|com.zuimeia.suite.nicecountdown
微在趣闻社|com.owspace.wezeit
TIM简约键盘|com.terry.tim
Adobe取色器:Adobe Color CC|com.adobe.creativeapps.colorapp
老黄历通胜-日历万年历择日|oms.mmc.app.almanac_inland
每天读点故事|com.dudiangushi.dudiangushi
wp8 - Xperia主题|com.liwind.windows
MyGesture的高级功能扩展插件|me.hisn.hipanel
爱玩|com.netease.iplay
360 Security Lite|com.qihoo.security.lite
神奇脑波|imoblife.brainwavestus
魔盒|cc.lakor.app.systemhelper
DIY动态头像|xiao.wen.xf
喵街|com.taobao.shoppingstreets
Cardicons Ⅱ 图标包|cookdev.iconpack.ii
卖座电影|com.hyx.maizuo.main
500px中国版|com.fivehundredpx.viewer.main
Adobe Scan|com.adobe.scan.android
沙发管家手机版|com.shafa.market.helper
全球付钱包|epaylinks.global.payment
VICE中国|asia.digitalcreative.vice
DailyCost|com.sevendosoft.tools.everydayaccount
诺伊写作|com.not_only.writing
音乐变速播放器|com.example.administrator.speedmp3
小鱼天气|cn.microsoft.cig.uair
Zara服饰|com.inditex.zara
东方头条|com.songheng.eastnews
Lingvist|io.lingvist.android
鲜果读书|com.xianguo.book
贝贝|com.husor.beibei
作家助手|com.yuewen.authorapp
懒人周末|com.lanrenzhoumo.weekend
财联社|com.lanjinger.choiassociatedpress
极致-双画风华为主题EMUI9.0/9.1|emui.en.com.jizhi
猪八戒|com.zhubajie.client
真实来电|com.truecaller
西集全球购|com.cn.xiji
索尼动态镜头:Motion Shot|com.sony.motionshot
百度有钱花|com.baidu.umoney
去哪儿机票|com.mqunar.qua
南方周末|com.infzm.ireader
留白WHITE|com.kiwi.android.whiteandroid
乐流|cn.raventech.musicflow
犀牛故事|com.rhinocerosstory
拾柒|com.shiqichuban.android
文件闪传|app.eleven.com.fastfiletransfer
三星杂志|com.mci.smagazine
一加邮箱|com.netease.mobimail.oneplus
一生必读的历史书|com.ireadercity.b4
Xperia Theme XPERIA LOGO|com.jackblack.xperiathemexperialogo
六只脚户外线路|com.topgether.sixfoot
滚动图标|com.mandg.funny.rollingicon
超级星饭团|com.superstar.fantuan
闪电换机 腾讯官方通讯录照片应用资料同步|com.tencent.huanji
网易帐号管家|com.netease.urs.android.accountmanager
HP Print Service 插件|com.hp.android.printservice
简图|io.egg.jiantu
快影|com.kwai.videoeditor
解方程计算器|com.equation.tool
肆客足球|cool.score.android
本来生活|com.android.benlailife.activity
想看|com.xiangkan.android
神奇小部件—图片/美句/倒计时/快捷支付/最近应用推荐/幻灯片/小部件/APK提取|com.sun.quickpay
美乐时光|com.meile.mobile.scene
酷FM|com.kugou.fm
笑神来了|com.zuobao.xiaobao
EZ截屏|com.skyrimcloud.app.easyscreenshot
百度 Hi|com.baidu.hi
微快递|com.kuaibao.kuaidi
强制旋转屏幕|xqgchstrnpepper.Orientator
想去|com.xiangqu.app
百度汉语|com.baidu.dict
食色|com.kingnez.umasou.app
Go应用管理|com.goplaycn.appmanager
当前进程|me.omico.currentactivity
DU GIF Maker|com.duapps.gif.emoji.gifmaker
流量宝|com.corp21cn.flowpay
英语四级单词|com.csj.cet4word
PDF阅读器|com.eleven.app.pdfreader
粉笔考研题库|com.fenbi.android.kyzz
还呗|com.shuhekeji
爱作业|ai.zuoye.app
充电助手|net.canking.power
UClean|com.ucweb.master
婚礼纪|me.suncloud.marrymemo
文言文|com.kk.poem.wyw
华为主题寻梦浪闲版 EMUI8.0|emui.en.com.dreamfinder
东奥会计课堂|com.dongao.mainclient.phone
巴哈姆特|tw.com.gamer.android.activecenter
纹字锁屏|com.iooly.android.lockscreen
二维码|com.iflytek.inputmethod.codescan
网易支付|com.netease.epay
悟空问答|com.ss.android.article.wenda
Recovery神盾(for hermes)|com.ZNLDKS.RecoveryShieldforhermes
Zone翻译|com.mixiaoxiao.translate
iFlat+|org.haleclipse.iconpack.iflatx
得意生活|com.deyi.client
悠悠驾车|com.uu.uueeye
滤镜格子|com.cam001.filtercollage
考试100|cn.kaoshi100.view
雷锋网|com.leiphone.app
函数画图|com.graph.myapp
ASUS PhotoCollage|com.asus.collage
19楼|com.nineteenlou.nineteenlou
乐动力跑步|cn.ledongli.runner
锁屏大师:CM Locker|com.cleanmaster.locker
CM Transfer - Share file...|com.cmcm.transfer
宁波银行|com.nbbank
透明图标包（不再更新）|com.touming.iconpack.pandecheng
纳米盒|com.jinxin.namibox
蛋卷基金|com.xueqiu.fund
萌小助|cc.komiko.mengxiaozhuapp
段子达人|com.roboo.joke
小目标 - 你的目标助理|cn.xyiio.target
层层抠图|com.myfrustum.rinpoche
柚子相机|com.meitu.pomelo
GPS导航|com.sygic.aura
宝宝巴士奇妙屋|com.sinyee.babybus.talk2kiki
V2er - 好用V2EX客户端|me.ghui.v2er
零件|com.surine.withher
平行空间精简版|com.parallel.space.lite
天天果园|com.ttxg.fruitday
京东股票|com.jd.stock
星尘浏览器|com.chaozhuo.browser_lite
纵横小说|com.zongheng.reader
乐学高考|com.lexue.courser
沪江学习|com.hujiang.normandy
书签助手|pro.kisscat.www.bookmarkhelper
带壳截图|com.One.screenshot
全面屏O(史上最强大的MIUI主题)|fxx.o
蚂蚁短租-民宿公寓预订|com.mayi.android.shortrent
UC桌面|com.uc.news
纯记账|com.six.accountbook
甘肃移动掌上营业厅|com.xinyue.gsmobilewxzt
求解_|meta.z.equationsol
烂笔头|com.ted.jots.myjot
车到哪|com.tonglu.app
Hey 浏览器|omark.hey
Color多彩手帐|com.cxwx.girldiary
英语音标|com.binfenyinbiao.binfen
网易游戏论坛|com.netease.gameforums
爱鲜蜂|com.bjzcht.lovebeequick
电脑控|com.pw.pccontrol
Quick Android Tools|instant.pm.fandaria
最美闹钟|com.dotools.clock
喜鹊儿|com.kingosoft.activity_kb_common
Lines Free - Icon Pack图标包|com.natewren.linesfree
Zoom云视频会议|us.zoom.videomeetings
印象笔记|com.yinxiang
悬浮球|cn.bobsky.mtouch.common
深圳地铁官方APP|com.iss.shenzhenmetro
水滴清单|com.quickwis.shuidilist
酷家乐装修管家|com.qunhe.rendershow
全国违章查询|cn.mucang.xiaomi.android.wz
人人都是产品经理|com.woshipm.news
AndroLuaJ|com.mythoi.developerApp
Dr.Web反病毒手机基本保护|com.drweb
最美自拍|us.pinguo.selfie
语文100分|com.kk.kkyuwen
360同步助手|net.qihoo.mobilesafe.syncassistant
梨视频|com.mobile.videonews.li.video
魅族遥控器|com.meizu.flyme.remotecontrolphone
META计算器|meta.z.calculator
摩斯电码|com.xcn.Morse
自然科学计算器:Natural Scientific Calculator|roviminteractive.materialcopy
新华社|net.xinhuamm.mainclient
Bootanimation - Substratum主题|cn.lirui.bootanimation
信用管家|com.greate.myapplication
华为主题纯粹男生版EMUI8.0|emui.boy.com.pure
AR Stickers|com.google.vr.apps.ornament
微软健康:Microsoft Health|com.microsoft.kapp
花伴侣|cn.com.robusoft.floweridentification
极客时间|org.geekbang.geekTime
文件管理器|com.zsorg.piyell.filemanager
豌豆公主|com.wonderfull.mobileshop
读者|com.skyxlink.digitreader
音乐可视化（音乐云谱）|com.music.visualization.week
无讼|com.tiantonglaw.readlaw
口袋兼职|so.orion.sharejob
OneShot - 截屏助手|me.next.oneshot
必收|com.gzqwkj.cshu
小站雅思|com.zhan.ieltstiku
联想指南针|com.lenovo.compass
数读|com.ifanr.android
创意设计|com.yidian.design
DU启动器:DU Launcher|com.duapps.dulauncher
本间芽衣子ほんま めいこ-Xperia主题|com.twowan.honmameiko
simpleC|com.luoye.simpleC
Baidu Browser Mini|com.baidu.browser.inter.mini
360浏览器迷你版|com.qihoo.expressbrowser
识谱大师|com.whj.app.stavemaster
当前界面(当前Activity)|com.toshiba.packagenamedetector
极光浏览器|com.k99k5.aurora
简易文件管理|com.ranfeng.androidmaster.filemanager
中文笔顺|com.patgdut.chinesestrokesorder
ASUS Share Link|com.asus.sharerim
ES应用锁|com.estrongs.locker
日事清|com.rishiqing
Lawnchair 启动器|ch.deletescape.lawnchair.ci
氢风重制版-Substratum主题|cn.luojuly.H2O
佳能移动打印|jp.co.canon.oip.android.opal
爱莫助手|com.airmore
一加方形图标包:Square Icon Pack|com.oneplus.iconpack.square
野兽骑行|com.beastbikes.android
云梦|com.soundario.app
Taguage|com.taguage.neo
电e宝|cn.com.htjc.pay
时光小屋|com.liveyap.timehut
英汉字典|com.bravolol.bravolang.englishchinesecdictionary
腾讯路宝|com.tencent.navsns
造作|com.zaozuo.android
隐形桌面小部件+|tk.mygod.invisibleWidgetPlus
GEAK录音机|com.geak.soundrecorder
百度旅游|com.baidu.travel
Timery|net.icycloud.timer
绿色应用评测|ml.qingsu.greenrunner
便签|com.example.ljh99.note
猫饼|tv.xiaodao.xdtv
手机网盘|com.sharpcast.sugarsync
格林|com.greentree.android
系统更新 - LR.Team|com.sun.beizikeji.ota
每日一题腰果公考|com.appublisher.dailylearn
Worktile基础版|com.worktile
蹭网杀手|com.cengwangshashou.apps.by.liyi
优拜单车|com.yl.ubike
灯塔专业版|com.alipictures.moviepro
滴答表盘|cn.foxday.hf
Adobe Capture CC|com.adobe.creativeapps.gather
韩剧迷|com.bccv.zhuiyingzhihanju
北京地铁|com.subway.bjsubway
你的日记|com.oh_name
当贝影视快搜|com.dangbei.kuaisou
Flow 2|com.drediki.flow20
游戏比价|com.gamechecker.towardfai.gamechecker
视频大师|com.yixia.videomaster
斗图表情|com.emojifair.emoji
摩托邦|com.motoband
路口|com.lukouapp
名人朋友圈|com.sencent.mm
嗒嗒巴士|com.newdadabus
新华书店|com.xinhuaezhan.bookStore
Quick浏览器|com.quick.android.browser
易控|com.broadlink.rmt
CM天气:CM Weather|com.cmcm.weather
Huawei Lucky Money Assistant|com.huawei.lucky_money
凯迪社区|net.kdnet.club
iOS 11风格-klwp|ios.tokipukey.kustom.pack
视+AR|cn.easyar.sightplus
Adobe Premiere Clip|com.adobe.premiereclip
双色球|com.mango.doubleball
Calci计算器|com.iraka.calci
匹诺曹通话录音|com.cungu.callrecorder.ui
时光笔记|com.sendtion.timenote
魔力视频2|com.molitv.android.v2
圆通速递|com.yto.client.activity
变声盒子|com.jaytronix.echovox
兼客兼职|com.wodan.xianshijian
Windows 10 Pack|com.coverage.windows
Swift Light-substratum主题|com.brit.swiftlight.substratum
麒麟取名起名字|com.haiyuan.shicinaming
众安保险|com.zhongan.insurance
MxGTD|com.zncm.mxgtd
度秘|com.baidu.robot
乱葬岗(此主题已停更，请关注【华为主题xin EMUI8.0】)|cn.coldsong.xin
多核观测器|com.mediatek.multicoreobserver
时间戳日记|com.candydiary.dawn
微记账|com.kunxun.wjz
Bus365汽车票|cn.nova.phone
达达骑士版|com.dada.mobile.android
Cube-Substratum|com.tmou.cube
晒书房|com.peptalk.client.shaishufang
视频动态壁纸省电版|com.simple.video.lwp
磁贴|com.yuanwofei.quicktiles
对啊课堂|com.duia.duiaapp
下文|com.hm.op.yg_news
Wake|com.wakeyoga.wakeyoga
Pass图标包|com.frankie.iconpack.pass
安卓精灵|com.ef.azjl
网速限制(限制自己网速)|com.yudao
华为阅读|com.huawei.hwireader
股票雷达|com.forecastshare.a1
路由宝|com.youku.assistant
西班牙语助手|com.eusoft.eshelper
短信伪造|cn.xtasker.fmsg
相机360|camera360.lite.beauty.selfie.camera
中国广播|com.shinyv.cnr
明道|com.mingdao
Whirlpool开机动画|com.markusslugia.theme.whirlpool
233网校考试通|com.example.examda
Steam Lite|com.valvesoftware.android.steam.community.china
起名大师|com.ggeye.babymingzi
Adobe Photoshop Fix|com.adobe.adobephotoshopfix
Best Trace|net.ipip.traceroute
许鲜|com.xuxian.market
Runtastic Me|com.runtastic.android.me.lite
糖豆|com.bokecc.dance
回家吃饭|com.privatekitchen.huijia
建工计算器|com.glodon.constructioncalculators
2nd World-面板顶栏美化主题|com.aidenwong.headerpack.vol2
爱屋吉屋|com.manyi.lovehouse
建行企业银行|com.ccb.companybank
影视大全-vip电影网|com.hoge.appivihzh1g4k
EZCast|com.actionsmicro.ezcast
艾宾浩斯复习笔记|com.spuxpu.review
证件照研究院|com.leqi.IDPhotoVerify
新浪微盾|com.sina.vdun
GO输入法|com.jb.emoji.gokeyboard
黑鸟单车|com.bamboo.ibike
携程攻略|com.android.ctrip.gs
津巴布韦刷机助手-多元化刷机辅助|com.Coolighting.jinbabuweishuajibao
洋码头|com.ymatou.shop
毒汤日历|com.shuodao.toxic
滴滴顺风车|com.sdu.didi.beatles
Tinted Statusbar-CM主题|com.luojuly.Tinted2
郁金香运动|com.tulipsport.run
PS消息 PlayStation®Messages|com.playstation.mobilemessenger
上行速 - 网速悬浮窗|com.by_syk.netupdown
欢喜云同步工具|com.smartisan.mover
闪念ToDo|com.kdfly.todo
59store掌上便利商店|com.huanxiao.store
MP3提取转换器|com.fuyou.aextrator
ACG.RIP - ｸﾞｯ!(๑•̀ㅂ•́)و✧ 听说长的帅的、美的用过都给了五分！！！|star.iota.acgrip
微博头条|com.sina.app.weiboheadline
拍大师|com.aipai.paidashi
OnePlus NFC|o.n
爱剪辑手机版|com.shineyie.aijianji
微软图片锁屏:Picturesque Lock Screen|com.microsoft.androidapps.picturesque
皮皮影视|cn.pipi.mobile.pipiplayer
小乖鱼 - 视频图片下载|com.moage.browser
小米鉴定|com.xiaomi.antifake2
同声翻译超级版|android.translate.xuedianba
Rufus图标包|com.benx9.poppy
余音|fm.wawa.mg
猎豹流量大师|com.cmcm.flowmonitor
最爱电影 — 发现最新电影资源|life.wolfheros.wmovie
去特么的密码|cf.paradoxie.dizzypassword
Lite Notes|com.litenotes.android
资讯狗-新闻聚合|com.torment.news
Nintendo Switch Online|com.nintendo.znca
一知|com.jaxim.app.yizhi
玲珑密保锁|com.kingsoft.android.cat
双龙 中文版|com.jakting.overwatch
720yun|com.seven.two.zero.yun
妙读|com.miaodu.reader
轻识别 - SmileSoft                                                                        (OCR)|com.smile.ai.ocr
一加小部件|net.oneplus.widget
神漫画|com.comic.shenmanhua
大姨吗|com.yoloho.dayimalite
QQ说说管家|com.dzan.ssds
网易贵金属|com.netease.ntespm
英伟达SHIELD 娱乐中心|com.nvidia.tegrazone3
ZMI随身路由器|com.xiaomi.mifi
Wokamon走星人|com.wokamon.android
知亦行|com.android.zhixing
Forza 足球|se.footballaddicts.livescore
一加自启动管理|com.gy.yjzqd
115浏览器|com.yyw.fastbrowser
爱的坐标|com.carlos.hus
AutoRap自动说唱|com.smule.autorap
McAfee安全套件:McAfee Security & Antivirus|com.wsandroid.suite
美骑|com.biketo.cycling
蜜芽|com.mia.miababy
联想录音机|com.lenovo.recorder
鸟人户外|com.nianren.activity
叽里呱啦|com.jiliguala.niuwa
JusTalk|com.juphoon.justalk
33IQ|com.jichuang.iq.client
小牛管家|com.niu.cloud
_(：з」∠)_|com.jakting.tangqiang
优记|com.ofans.lifer
氧气云音乐|com.kachidoki.oxgenmusic
画江湖|com.ruosen.huajianghu
空气锁屏|com.zuimeia.suite.magiclocker
柴扉|cc.huochaihe.backtopast
搜我吧|com.mythoi.souwoba
脸优|com.baidu.faceu
易互动|com.konka.MultiScreen
上海银行|cn.com.shbank.mper
云搬家|com.imwallet
触宝输入法HTC版|com.emoji.keyboard.touchpal.oem
歌者盟学唱歌|com.gtan.church
强力通话录音|com.glgjing.mickey
CSDN+|com.ifreedomer.cplus
白|com.whiterss
夜间护目镜|com.friendlove.huyan
Amigo指南针|jlzn.com.android.compass
菠萝饭|com.joyworks.boluofan
氧化氢-klwp动态壁纸|com.neoncloud.klwp.wateros
汉语词典|com.kk.dict.cidian
讯飞配音|com.iflytek.peiyin
MyWallpaper|com.zhangbohun.mywallpaper
神剪手|cn.wondershare.filmorago
下载宝|com.xunlei.timealbum
玩美彩妆|com.cyberlink.youcammakeup
百资繁体中文输入法（注音、仓颉、速成、手写）|com.linpusime_tc.android.linpus_tckbd
iONS图标包|com.ions.pack
曾几|bos.consoar.lasttime
时钟插件|com.example.zhanglulu.clockwidget
Doco纪录影院|com.doco.film.sx
中国好铃声|com.qxtimes.ring
伪装位置-FakeGPS|com.kanchsproject.fakegps
八角星视频|cn.com.wanyueliang.tomato
验证码提取器|com.github.tianma8023.smscode
Candy时钟|com.candykk.android.deskclock
育学园|com.drcuiyutao.babyhealth
华股财经手机炒股票软件|com.dayingjia.stock.activity
铁血军事|com.tiexue.ms
全民K歌导歌|com.quanminkghuoqu
justDo - 日常vs习惯|com.android.justdo
一加时钟|com.oneplus.deskclock
XyMemo|com.naxy.xymemo
码云|net.oschina.gitapp
华硕Splendid|com.asus.splendid
关机重启|ttclub.reboot.nosu
Lawnfeed-魔趣定制版|org.mokee.lawnchair.lawnfeed
果库|com.guoku
海尔优家|com.haier.uhome.uplus
MIUI中心时钟|com.cpu82.miuicenterclocl
欧路词典国外版|com.qianyan.eudic
咩咩|com.suda.yzune.youngcommemoration
带壳截图|lua.ke.screenshot
字云|com.tutao.ziyun
桔色|com.orangex.orange
THING桌面|com.thing.launcher
Lavender(国家地理每日图片精选)|party.danyang.nationalgeographic
AIDE手册|com.learn.aide
车主无忧|com.starbaba.starbaba
联想计算器|com.lenovo.calculator
MD5检测|com.zzapp.md5test
沃家云盘|com.chinaunicom.wocloud
华硕电子邮件|com.asus.email
最美装修|com.suryani.jiagallery
Xperia™冰蓝主题|com.anjulnami.xperiaicebluetheme
包名查看|com.xcn.baoming
出发吧|com.jianlv.chufaba
天虹|cn.rainbow.westore
暴风魔镜|com.baofeng.mj.mini
雨季|com.czh.weather_v6
二维码生成器|com.oboard.qr
鲜城|com.weibo.freshcity
一加不规则图标包|com.oneplus.iconpack.oneplus
长安通|com.xaykt
HelloWorld|com.zhimeng.helloworld
边缘手势（导航手势）|com.ZPeng.FloatTasks.NavGesture
i兰大易班|com.lzu.yuh.lzu
悬浮导航-边缘手势|com.ZPeng.FloatTasks
经纬海拔|com.example.loong.mylocation
轻之文库 - 超本格轻小说创作平台|net.linovel.keiko
高级按键 - SmileSoft|com.smile.advancedkeys
WALKUP|com.walkup.walkup
选择媒体|tool.xfy9326.selectmedia
拼接工坊|me.zheteng.android.stitchcraft.china
搜狗翻译|com.sogou.translator
通话记录工具|com.candykk.calllog
网易游戏|com.netease.nieapp
米键|com.xiaomi.miclick
企鹅众测|com.tencent.tesly
MI UI 9图标包|com.rainystudio.miui9iconpack
学而思网校|com.xueersi.parentsmeeting
为你读诗|com.thepoemforyou.app
传阅|com.gao7.android.weixin
同花顺iFinD|com.hexin.ifind.android
橘子娱乐|com.happyjuzi.apps.juzi
问果桌面|com.guobi.winguo.hybrid
360安全云盘|com.qihoo.cloudisk
Halo浏览器|com.halo.browser
学而思|com.xes.jazhanghui.activity
Adobe Draw|com.adobe.creativeapps.draw
Systemui Advanced Manager-Substratum主题|cn.luojuly.systemui
恋恋|os.xiehou360.im.mei
Memobird咕咕机|cn.memobird.app
建筑学院|com.yundiankj.archcollege
多闪|my.maya.android
狼人世界|com.wodidashi.wolf
阿甘跑步|cn.runagain.run
AirClip|me.yourbay.airclip
蜂鸟众包|me.ele.crowdsource
DynamicEnv|tiiehenry.dynamicenv
无限人偶|com.rn.pofi
GEAK Calculator|com.geak.calculator
徽商银行|com.hsbank.mobilebank
豆腐|com.taptech.doufu
戒烟军团|com.nxnresearch
诊疗助手|com.ts.zlzs
网速悬浮窗|com.zhanhong.speed
Ocamera|com.qinlin.ocamera
上海地铁官方指南|com.shmetro
速播体育|com.subo.sports
应用翻译器:App Translator|org.pjf.apptranslator
氢气球旅行|com.chanyouji.inspiration
毒物|com.poison.sylar
随身集合石|com.netease.meetingstoneapp
羊城通|com.gzyct.yctwallet
掌上300英雄|cn.nicolite.palm300heroes
LISTENit-Stunning Music Player|com.ushareit.listenit
语音输入板|cn.aiworks.note
飞地|cn.enclavemedia.app
P Mod For Xperia™ 索尼Android P 主题|com.zerosimple.androidp
Java模拟器（J2ME Loader）|ru.playsoftware.j2meloader
AppPlus|com.gudong.appkit
WPS日历|com.kingsoft.calendar
Bilibili With Honkai-面板顶栏美化主题|com.aidenwong.headerpack.bilibiliwithkonhaivol1
kds宽带山|net.pchome.kds
图片压缩|com.compressthepicture
付小计|com.tadhg.accountbook
美咖相机|com.rongcai.show
ES应用分身|com.parallelspace.multipleaccounts.appclone
远程开机棒|cn.sharepeople.wol
租租车|com.zuzuChe
达令全球好货|com.ymall.presentshop
看见音乐|com.kanjian.radio
卡片翻译|small.card
追不 - 追剧助手|com.echo.keepwatch
携程企业商旅|com.ctrip.ct
索尼跑走健身WalknRun|com.sonymobile.ippo
拉卡拉手环|com.lakala.cardwatch
唔哩头条|com.caishi.cronus
桔子浏览器|com.juzi.browser
伴鱼英语|cn.xckj.talk_customer
凯恩之角|com.netease.cain
留声|com.camellia.voice_tool
QQ通知增强-支持wear os消息提示|com.jinhaihan.qqnotfandshare
必胜宅急送|com.yum.mos
NWindow（悬浮键）|com.xyiili.nwindow
安卓壁纸|com.bodong.androidwallpaper
听听FM|com.audio.tingting
秘迹|com.entropage.app
博客园|com.android.cnblogs
朝夕日历|com.zhaoxi
沃门户|cn.com.wo
荣耀阅读|com.huawei.hnreader
医考帮|com.yikaobang.yixue
疯狂造人备孕怀孕|com.bozhong.crazy
漫画控|com.manhuakong.activity
地球|yyc.dq
ROOT测试|com.atominvention.rootchecker
Super OS 图标包|com.lcool.superos
榕城通|com.fjby.cardnfc
画吧|com.haowan.huabar
小黑屋|com.sscience.stopapp
百变美图字体:Font Lab|com.finnalwin.fontlab
摄影玩家|com.yidian.photo
阻止唤醒[ROOT]|com.giovannibozzano.wakeblock
腾讯直播|com.tencent.qqlivebroadcast
穷游锦囊|com.qyer.android.qyerguide
画板|com.xiaomin.drawshop
悬浮图标|com.ksxkq.floaticon
Results|com.runtastic.android.results.lite
ETCP停车|com.ETCPOwner.yc
会计帮|com.duia.duiba
阿里妈妈|com.taobao.kepler
大容量存储(U盘配置)|com.sjj.echo.umsinterface
一加小工具:3T-Switcher|com.yorek.yloneplustools
显示大小|poqceo.displaysize
emo|net.luoo.FaceFM
米动健康|com.huami.midong
悦动浏览器|com.yuedong.browser
隐云图解制作-更方便的视频截图与台词拼接|com.equationl.videoshotpro
声音助手一一  三星专用|com.samsung.android.soundassistant
emui5.0 oreo 主题|emui.en.com.Oreo8
Bgm38|me.ewriter.bangumitv
抓娃娃大作战|com.bobozhua.androidclient
手电筒|com.polaris.shoudiantong
汉口银行|com.csii.hkb
12306订票助手|cn.suanya.train
乔布简历|com.qiaobutang
路由大师|com.tplink.tether
华硕韶光动态壁纸:ASUS LiveScenery livewallpaper|com.asus.livewallpaper.asusdayscene
第一财经|com.yicai.news
来电闪光灯|com.hd.fly.flashlight
古风诗歌产生器|moe.guo.poem
聚合阅读（不只是RSS阅读器）|holmium.marshalreader
Faded图标包|njad.faded.ifyourereadingthisitstoolate.iconpack
股票灯塔|com.dengtacj.stock
Zone悬浮球PRO|com.mixiaoxiao.touchassistant.pro
极客翻译|com.blindingdark.geektrans
Kuro - Substratum主题|com.pierx.kuro
你的名字-Xperia主题|com.yourcompanyname.yourname
MIUI语音识别|com.yaxisvip.miui.speechcloud
中原银行|com.csii.zybk.ui
Misfit|com.misfitwearables.prometheus
文玩迷|com.wenwanmi.app
墨签艺术签名|com.boxstudio.sign
海底捞|com.haidilao
美餐|com.meican.android
有书|com.fengwo.reading
Sonos安卓控制器|com.sonos.acr
网易菠萝|com.netease.bolo.android
河狸家|cn.zhimawu
耳机工具箱|com.chheese.app.HeadphoneToolbox
花海仓|com.vipshop.vshhc
M 笔记 - Markdown编辑器|com.hjq.md
掌上110|com.lvwan.mobile110
屏幕圆角|com.nylon.roundedcorners
白熊阅读|com.bearead.app
圆图标包|fxx.yuan
快读追书阅读器|cn.txtzsydsq.reader
华为视频|com.huawei.himovie
并读|com.nhzw.bingdu
咔嚓截屏|com.kacha.screenshot
Smalite New 图标包|iconpack.cz.smalitenew
番茄钟|com.ppyg.timer
AccuWeather|com.accuweather.android
换机同步助手|com.dada.syn
hao123上网导航|com.baidu.hao123
WiFi密码查看器|com.yeshao.wifipassword.jjb
Fastidious Me - Substratum主题|cirno.fastidiousme
最美壁纸国际版:ZUI Wallpaper-HD live images|com.zuiapps.suite.wallpaper.international
咪咕善跑|com.imohoo.shanpao
翻易通|com.flitto.app
小蚁行车记录仪|com.xiaoyi.car.camera
爱奇艺奇巴布|com.qiyi.video.child
粉笔司考|com.fenbi.android.sikao
袋鼠遥控|com.baidu.roocontroller
记住密码|com.shiguiyou.remberpassword
喵喵喵图标包|fxx.miao
青果全本免费小说|com.quduquxie
墨趣书法|com.moqu.lnkfun
随手一记（备忘通知）|com.github.xiaofei_dev.suspensionnotification
快捷输入|net.haoxf.fasterinput
天翼安全中心-手机管家卫士|com.anguanjia.security
申通快递|com.sto.express
white-king EMUI5 主题|emui.en.com.white1
VC Browser - Compact & Fast|com.vc.browser
米读小说|com.lechuan.midunovel
爱玩王者荣耀助手|com.kugou.iplay.wz
米家全景相机|com.madv360.madv
氢清理（原微信清理大师）|com.mavericks.wechatclear
循环计时器|com.finalweek10.android.cyclealarm
动嘴|com.shining.wulisay
军事头条|com.tiexue.mobile.topnews
银联迷你付NFC:MinipayNfc|com.unionpay.minipay.nfc
锤子驾驶|com.smartisan.drivingmode
影檬|com.lemon95.lemonvideo
迅雷镖局|com.xunlei.filemail
G动|com.beevle.xz.renxing.gdong
书云Pro|com.sjtu.chenzhongpu.cloudbooksPro
袋鼠输入|com.baidu.imesceneinput
人人词典|com.yyets.rrdict
一键锁屏|net.devwiki.lock
手机硬件检测|mobile.device.info
蕾姆-Xperia主题|com.twowan.leimu
火车票达人|cn.ikamobile.trainfinder
猎趣|com.yunmall.ymctoc
走遍美国英语|com.xiaobin.nusenglish
波罗蜜|me.bolo.android.client
WIFI密码Lite|com.wifi.password2
360透视镜|com.qihoo360.leakscan
Opera Max|com.opera.max.two
sleek+mix+和音字体|zi.ti.substratum
视力小测试|visiontest.health.eyetest
导航栏（无需ROOT）|tw.com.daxia.virtualsoftkeys
我是课程表|com.sunrain.timetablev4
讯飞语音合成助手|com.uvoice.iflyspeech
托福考满分|com.kaomanfen.kaotuofu
电视家(尝鲜版)|com.elinkway.tvlive2.beta
沃管家|com.cici.tiexin
轻松筹|com.qingsongchou.social
ADB WIFI|com.rair.adbwifi
悬浮辅助 - 全面屏手势-边缘手势-跳广告-悬浮球|com.magikie.assistant.touchproxy
1905电影网|com.m1905.mobilefree
面魔|com.xmoo.noface
360商城|com.qihoo.mall
南方Plus|com.nfdaily.nfplus
58违章查询|com.wuba.weizhang
剑灵掌游宝|com.anzogame.jl
360 Weather|com.qihoo.mm.weather
口袋故事|com.appshare.android.ilisten
CRI HitFM|com.linker.hfyt
网兜免费小说|com.sina.book
小米WiFi链|com.xiaomi.wifichain
游戏王卡片生成|com.nekmit.yugioh
米兔|com.imibaby.client
楚楚街|com.culiukeji.huanletao
高考日历|com.gaokaocal.cal
一日猫|com.threeWater.yirimao
百度VR|com.baidu.vrbrowser
哔哩缓存传输|com.cly.bilibilidownloadtransfer
批量视频转换|com.fuyou.tools.videoconverter
实时地球|com.chinars.todaychina
骑记|cc.iriding.mobile
丽芙家居|com.lifevc.shop
FloatPicture (悬浮图片)|tool.xfy9326.floatpicture
消息精灵|com.apusapps.tools.unreadtips
代码笔记|com.error.codenote
成语词典|com.kk.dict.chengyu
MSN美食|com.microsoft.amp.apps.foodanddrink
Xperia Theme SONY LOGO|com.jackblack.xperiathemesonylogo
喜付|com.buestc.wallet
华为主题纯粹酸奶版 EMUI5.0/8.0|emui.en.com.yogurt
表情助手|com.belly.stickersort
ALua手册—重生版|com.sf.ALuaGuide
单词本|host.spencer.wordbookapp
Air Quality  AirVisual|com.airvisual
海尔好空气|com.haieruhome.www.uHomeHaierGoodAir
搜狗输入法注音版|com.sogou.zhuyininput
旅图|com.erlinyou.worldlist
故事会官方正版|cn.storychina.aXMdDn1
重庆农商行|com.magicpoint.mobile.bank
像素断网:Pixel NetCut|pixel.com.netcut
Passsync|cn.ifengge.passsync
安徽农信手机银行|com.cn.froad.mobileplatform
沃家视频|com.android.wjtv
口语评测|com.hjenglish.app.dailyspeech
护目镜|com.eyefilter.night
巴适公交|com.guoke.chengdu.bashi
高考志愿君|com.borsche.zyb
导航栏|com.DBin_K.Lolipop.theme
北极星Office|com.infraware.office.link.china
一直Call|top.glimpse.constantcall
极客公园|net.geekpark.geekpark
最美锁屏国际版:ZUI Locker|com.zuimeia.suite.lockscreen.international
UCG电子杂志|com.bard.vgmagazine
山姆会员商店|cn.samsclub.app
南京银行手机银行|cn.com.njcb.android.mobilebank
QQ号码模拟|com.zzz.QQNumberSimulation
魔法分享 - Web内容分享助手|net.atlassc.shinchven.sharemoments
豹来电|com.cheetah.cmshow
Upshot|com.slegs.videoeditor
Jelly浏览器-lineageOS浏览器|org.lineageos.jelly
华硕海洋壁纸|com.asus.livewallpaper.asusmywater2
阿里邮箱|com.alibaba.cloudmail
内涵社|com.neihanshe.intention
我的字体|date.caizb.myfont
wp10 - Xperia主题|com.liwind.widows
MTK超级工程模式 EngineerMode|cn.EngineerMode_DBinK
ME微杂志|com.gli.cn.me
语戏|com.yuxip
完美录像|com.eversince.screenrecord
全局震动开关|hovn.app.global_vibration_control
vivo IME|com.baidu.input_bbk.service
乐Do|com.android.lesdo
中通快递|cn.beekee.zhongtong
月记|com.boohee.period
车行易查违章|com.violationquery
8tracks|com.e8tracks
小众推荐|xiaozhong.phone.com.mediapad
起风啦|qi.la.feng.newapp
千图|net.qiantuapp
诗词之美|com.hustzp.xichuangzhu.lean
镜子|com.android.hwmirror
阿里健康|com.citic21.user
薄荷阅读|com.chaoui.mintreading
武汉交警|com.yitop.mobile
Pure Alpha - Substratum主题|cn.pure.alpha
索尼xperia主题 V2|com.bansheealex.sony
万年历|com.calendar2345
Candy通讯录V2|com.candykk.android.contacts
cnβ|me.yugy.cnbeta
小特|com.xiaote
德邦快递|com.deppon.dpapp
华硕键盘|com.asus.ime
My浏览器|example.my40
设计君|duia.com.shejijun
模仿闹钟:Mimicker Alarm|com.microsoft.mimickeralarm
QQ浏览器VR|com.tencent.qvrplay
网易云音乐歌单匹配器|com.hongbojiang
流量v网|com.ailk.main.flowassistant
伪装系统升级|com.jobshuang.pretendupdate
小企鹅乐园|com.tencent.qqlivekid
诗词助手|com.WooGeeTech.poetassistant
图标设计师|com.bashtian.icondesigner
17TRACK|yqtrack.app
OnFire|com.bbonfire.onfire
IT桔子|com.itjuzi.app
古文典籍|com.kk.poem.djhjcpx
手机睿思|me.yluo.ruisiapp
吉他谱搜索|com.mw2c.guitartabsearch
拼好货|com.aimi.pintuan
文字识别|com.mike.textocr
BearyChat|com.bearyinnovative.horcrux
多多记账|com.tencent.android.duoduo
微录客|com.funinhand.weibo
Quick Pay (无需root)|com.quick.pay
沃尔玛|cn.com.walmart.mobile
流量安全管家|com.oupeng.safedata
Armageddon动态壁纸|com.maxelus.armageddonlivewallpaper
Nautilus壁纸包|com.benx9.wallpa
Mocard图标包|com.hklx.mocard
Candy日历|com.candykk.android.calendar
滑天下之大稽ヽ( ^∀^)ﾉ|me.lancer.pocket
VIPER HiFi|com.kugou.viper
磨铁阅读|com.motie.motiereader
韵达速递|com.yunda.app
清单|com.eqingdan
茄子播放器:S Player|com.ushareit.playit
魔力混音|com.xuhongxiang.musicboard
看电影|source.code.watch.film
讯飞电视助手手机版|com.iflytek.xiri.mobile
粤语字典|com.sjtu.chenzhongpu.cantonese
搜狗听写|com.sogou.dictation
快递员|com.kuaibao.skuaidi
MIUI抓猫工具|com.mkfssion.nekomanager
WPS文档|cn.wps.yun
坚果云扫描|nutstore.android.scanner
更准天气|com.aimobo.weatherclear
卿 · 翻译|com.qingyi
Moment|com.moment.keyboard
uTimeTable|hovn.app.utimetable
波奇宠物|com.boqii.petlifehouse
图片信息|com.ckdroid.imginfo
飞熊视频|com.fxtv.threebears
电话万能钥匙|com.imcaller
人言|com.zixintech.renyan
每日环球展览iMuseum|com.clover.imuseum
成就清单|com.weal.doit
点点日历|com.diandian.easycalendar
旅行箱|com.focustech.suitcase
Adobe笔刷:Adobe Brush|com.adobe.creativeapps.brush
手机电影|com.cnlive.movie
杭州银行|cn.com.hzb.mobilebank.per
单向历|com.owspace.OWSCalendar
双开神器|com.hanyuejian.hacker
穷游最世界|com.qyer.android.lastminute
飞常准业内版|com.feeyo.vz.pro.cdm
U玩|com.tm.uone
傲游5浏览器|com.mx.browser.star
比特球云盘（送VIP体验卡）|com.bitqiu.pan
噜咖VR-VR视频聚合|com.rockvr.vrcommunity
微软必应学堂|com.microsoft.academicschool
最美有物|com.zuiapps.zuiworld
天翼小号|com.chinatelecom.mihao
LYCSKY图标包--LP图标包|com.lycsky.iconpack
微警认证|cn.gov.weijing.ns.wz
共享图标包|com.e123.gxicon
Adobe Photoshop Sketch|com.adobe.creativeapps.sketch
xperia蓝色简约|com.yourcompanyname.cartoon
华硕智能管家|com.asus.mobilemanager
有间杂货店|com.vocinno.griefstore
验证码助手|com.zzy.captcha
视频剪辑助手|com.smallyin.vedioedit
拾光壁纸 - 一加摄影|com.todd_syk.onemoment
华为主题РRΟ|com.hwgroup.pro
华为主题(EMUI8.0及以下)-原OS|com.yuanos.masuku
趣味中国字|com.ifeng.zhongguozi
H2OS一加相机官方版|com.opxw.camera
猎豹输入法|com.cheetah.keyboard
Teams|com.microsoft.teams
新概念英语|com.tataera.xgnyy
Android入门指南|cn.ifreedomer.com.androidlearn
Free 3d Launcher桌面启动器、极致流畅、3D主题和壁纸|com.free.launcher3d
YOHO|cn.yoho.magazine
台风|com.sz.china.typhoon
鲁迅追番|pro.luxun.luxunanimation
小米读书|com.xiaomi.reader
网速悬浮窗|com.aimee.netspeed
伙伴办公|com.huoban
听戏|com.hualumedia.opera
朋友印象|com.yueren.pyyx
一键清理(免root版)|yudao.ql
好订网|com.hcom.android
GIF转视频|com.didikee.giftovideo
临境阅读|com.lbltech.linking
艺术云图|com.yuntoo.yuntooapk
搜狗地图MINI|com.sogou.map.android.minimap
美团旅行|com.meituan.tower
Anki 朗读器|com.blanke.ankireader
科沃斯机器人|com.ecovacs.ecosphere
包商银行|cn.com.bsb.mbank
齐家网|com.qijia.o2o
ScreenWake屏幕常亮|com.geeksammao.keepscreenon
每日英语|com.bs.english
百度股市通|com.baidu.fb
用其他浏览器打开|chenmc.open.with.specified.app
游天下|com.soufun.travel
轻笔记|com.thinkernote.ThinkerNote
好唱Show|com.michong.haochang
E-Ink Launcher|cn.modificator.launcher
乐居买房|com.leju.platform
Candy桌面|com.candykk.android.launcher3
余味|com.yuwei.android
Imit For Klwp|ljq201708.kustom.pack
淘宝大学|com.taobao.tdvideo
YHOUSE|com.yhouse.code
阿姨帮|com.ayibang.ayb
java编译器|antidestiny.java2dex
分贝测试仪|com.novv.dbmeter
四川航空|com.bw30.zsch
电量伪装[ROOT]|com.liming.camouflagebattery
lan - Xperia主题|com.liwind.lan
一键锁屏 - Looock Mini|com.zerosimple.looockmini
CM应用锁:CM AppLock|cms.lock
考研单词|cn.jk.kaoyandanci
地图淘金|com.baidu.lbs.crowdapp
读写U盘中的文件|com.paragon.tcplugins_ntfs_ro
青果|inwaves.qng
虚拟相机|top.nightfarmer.vcamera
腾讯炫境|com.tencent.vrvideo
康熙字典|com.kk.dict.dictkx
Unsplash壁纸（官方）:Unsplash Wallpapers|com.unsplash.wallpapers
Psnine|com.psnine
网易财经|com.netease.money.i
斑马隐私管家|com.pengyou.zebra
古诗词学习|com.easysay.poem
哔哩封面姬|cn.heyan.misscover
Mate20ProCheck|pro.mate20
进制转换计算器|com.github.xiaofei_dev.radix
智能镜头|com.google.ar.lens
极简计算器|com.log.jsq
表情豆豆|com.facetech.emojiking
wi极简输入法|com.hit.wimini
Gaaiho PDF阅读器|com.zeon.Gaaiho.Reader
掌上理工大|com.wutnews.bus.main
Orimuse|com.orimuse.android
在家点点|com.zaijiadd.customer
搜狐视频VR|com.sohuvr
美拼|com.color365.meipin
逗比相机|com.meibaoapp.shine
PaletteHK|com.fotoable.palette.hk
万能相机|com.meitu.boxxcam
ANMPP[超级主机]-Nginx\MySQL\PHP-FPM\PostgreSQL\FTP SERVER|xiaoqidun.anmpp
网易BoBo|com.netease.vshow.android
看鉴微视频|cn.com.kanjian
s8-索尼xperia主题|com.acai.s8xperia
有读故事|com.orange.maichong
YoMail邮件客户端|com.yomail.app
托福单词|com.zhan.toeflword
创业邦|com.cyzone.news
[Evolution Performance+] Rosso - Xperia™主题|com.highlight.novatsuki.rosso
超鱼TV|com.zhsj.tvbee
第一财经周刊|com.cbnweekly
美寄云贺卡|com.moage.meiji
果冻橡皮章|la.guodong.orange
Stitch|com.inklin.stitch
快捷支付|com.suda.openpayshortcut
书入法|me.shurufa
览书阅读|com.lanshu.lsnr
多少天后啪啪啪|xyz.hanks.papapatimer
Mix Music|com.chaosgoo.mixmusic
music - Xperia 主题|com.liwind.music
yoo视频|com.tencent.firevideo
腕间图库 -开源手表图库应用|cc.chenhe.weargallery
Readhub+ 新闻|cn.marno.readhubplus
DOV-全新真朋友趣味社交|com.tencent.qim
浅风|com.One.Color
墨者|com.mozhe.mzcz
Andream记事|com.andreamapp.note
小美语音助手|com.beautylife.va
斗鱼手游TV|air.mobilegametv.douyu.android
一隅|com.inacorner.literature
AR相机|com.zwenyu.pandora
去哪儿火车票|com.qunar.train
淘集集|com.huanshou.taojj
游戏加速插件|com.imoblife.gamebooster_plug_in
耳机按键设置|tool.xfy9326.earphonekey
室内温度计|com.dtw.batterytemperature
终极加速|TIIEHenry.MAXRUN
魔幻手指-动态壁纸锁屏DIY|com.magic.finger.gp
瓦拉淘|com.walatao.walatao
MSN健康|com.microsoft.amp.apps.binghealthandfitness
水印宝|com.shuiyinbao.android
Apsu 3D Launcher 2018 桌面 启动器 主题、壁纸|com.phone.launcher.android_live_HD_wallpaper_efficiency_customize_apsu
Xperia Theme XPERIA LOGO White|com.jackblack.xperiathemexperialogowhite
文图|com.qienanxiang.tip
Gemini Square 图标包|com.clydeshenry.iconpack.gemini.s
PYRO音乐|cn.pyromusic.pyro
Custed|cn.custed.app
妹子图|com.weihuagu.meizi
手机振动器|com.zhanhong.vibrator
隐私月月记|net.android.wzdworks.magicday
初音ミクHatsune Miku - Xperia主题|com.yourcompanyname.hatsunemiku
WithMe私密日记本|com.conglaiwangluo.withme
滑稽表情包|lea.emoji.hj
手绘左下图标包|com.ddiu.iconpack.anotherzuoxia
好看锁屏杂志|com.haokanhaokan.lockscreen
字里行间|com.duodian.zilihj
书藏家|io.jft.bookshelf
彩色气球|com.leaplock.moments
热门话题|com.rhct.android.rhctapp
BookShelf|com.smartjinyu.mybookshelf
WeSecure|com.tencent.qqpimsecureglobal
不厌书法|com.buyanchuantong.buyanshufa
WiFi万能钥匙主人版|com.linksure.wifimaster
C语言教程|com.learn.cadd.study
汕头公交Minus|bobo.shanche
昕浏览器 Pro|com.adymilk.easybrowser.por
看山|com.kanshanjishui.kanshan
Meeye 图标包 Xperia 扩展主题|com.yeyebbc.meeyeiconpackadditionaltheme
浙商银行|com.czbank.mbank
翻篇儿|com.dangdang.lightreading
大家车言论|com.pengke.djcars
Flutter Gallery|io.flutter.gallery
Fake Safari|com.apple.safari
滑稽-Xperia主题|com.luojuly.funny2
光阴似箭|hotsoft.focus.timemanager
万能拍照识物|com.xsg.pi
qq助手|com.sweeperforqq.android
华为主题(EMUI5.1及以下)-银河|com.galaxy.masuku
快手闪电狗（无水印下载作品）|com.GIFLightningdog.zmh
Own日记|com.sumxiang.noteapp
GO浏览器|com.mediawoz.xbrowser
沃宽|com.lt.wokuan
皮皮影视HD|cn.pipi.mobile.pipiplayer.hd
OpenSetting - 设置快捷方式|com.mycompany.setting
3D东东|com.wztech.mobile.cibn
终极应用搬家|com.xiaomistudio.tools.app2sd
HEX|com.baidu.browser.hex
Office遥控器:Office Remote|com.microsoft.office.officeremote
Launcoogle - Google 启动器|net.rachel030219.launcoogle
索尼xperia未来主题体验版|com.yourcompanyname.xpeirfuture
Vainglory Go - 1.5.0全新设计|vcoty.vainglory.go
鲁大师VR评测|com.ludashi.vrbench
畅游十|com.changyou.zzb
大冲流量助手|com.pingan.pingandata
搜谱|com.yun.opern
扩列|com.Eldard.KuoLie
CC 速成班|com.crashcourse.china.c17
时光猫|com.time.cat
艺术头条|com.artron.toutiao
solar system - Xperia主题|com.liwind.solarsystem
江西银行个人手机银行|com.csii.ncbank.ui
易屋铵 圆图标包！- 圆到底！|cc.cinyu.rricon
小镜子|com.polaris.mirror
文字图片生成器（文字转图片）|tk.dracloud.text2pic
Now正念冥想|com.imoblife.now
高考好志愿|com.gkhzy
设计本|com.to8to.wireless.designroot
简约天气|online.laoliang.simpleweather
飒漫画|com.comic.isaman
音乐闹钟|com.mine.musicclock
归途wallpaper|com.mttipoghxx1007
网易美学|com.netease.meixue
东莞银行|com.mbank.dongguanbank
上线了|com.strikingly.android.taizi
派代随身|com.paidai
PicsArt Animator: Gif & Video|com.picsart.animate
猎豹锁屏大师壁纸:Colorful CM Locker Wallpaper|com.cmcm.locker.colorful
几维遥控器|com.vizone.rfcontroller
AI助手-你的实用人工智能助手(图像识别,自然语言识别)|com.yeliheng.aiassistant
挑战Plank|cn.pocdoc.sports.plank
趣刻|cn.hugeterry.coderfun
新漫画|com.cf.xinmanhua
自测用药|com.bingbuqi
麦萌漫画|com.cn.maimeng
天翼阅读|com.lectek.android.sfreader
装修图库|com.to8to.tuku
乐播|com.baidu.music.lebo
捷报比分|com.nowscore
共享e家|com.shareplus
Flutter Gallery|io.flutter.demo.gallery
苏宁阅读|com.suning.mobile.subook
PureMusic|org.zack.music
瘦瘦-健康瘦身减肥顾问|com.xikang.android.slimcoach
PINS|com.wecut.pintu
VSCAM|com.x.vscam
腾讯企鹅辅导|com.tencent.k12
爱流量|com.aspirecn.dcop
鲜柚桌面|com.appwill.lockscreen
Note|com.example.admin.note
隐式启动|xyz.hanks.launchactivity
FlickMoment相册|com.xvideostudio.flickmomentlite
自在找|com.nut.blehunter
应用管理|com.luapp.apps
看房-买房、找房、楼盘、房产、看房团|com.tencent.qqhouse
雅思考满分|com.enhance.kaomanfen.yasilisteningapp
魅族手环|com.meizu.smart.wristband
秒回助手-快速回复微信QQ消息|zaki.specialfocusassistant
Mcool音乐播放器|diystar.mcool
加热手机|io.github.skyhacker2.heatupyourphone
哈勃|com.tencent.habo
我的设备|com.jinhaihan.mydevice
Zapya WebShare - File Transfer|com.dewmobile.kuaiya.web
虚拟大师|com.vmos.app
中银易商|com.boc.bocop.container
Ctrl + —— 给手机装上Ctrl键|com.lerist.ctrlplus
一加微件通用版|net.oneplus.widget.nononeplus
飞傲音乐|com.fiio.music
滚去xx（原滚去睡觉）|com.woc.sleep
带我飞|com.dwf.ticket
开始吧|com.kaistart.android
万年历日历|cn.etouch.ecalendar.life
工程测量大师|com.CDAStudio.SurveyMasterProAndroid
权限狗 AppOps|com.web1n.permissiondog
定时关机|com.lingdeqin.timeup
亿家健康|com.hk515.patient
污托邦|com.A4comic.WOOOH
XPERIA™ The Angry Birds Movie|com.sonymobile.themes.angrybirdmovie
搜搜图|com.ckdroid.seachimg
青岛公交查询|com.qingdaonews.bus
Mapapers|com.matteolobello.mapapers
短信夹|com.mida.messagehelper
小日子|com.huodongjia.xiaorizi
Sprightly|com.microsoft.mobile.sprightly
备用机|com.ckdroid.backupphone
全国12315互联网平台|com.zrar.qghlwpt
读者在线|com.llq.reader
一加计算器|com.oneplus.calculator
咖啡图标包|com.chabei.iconpack.coffee.pro
汇丰银行|cn.com.hsbc.hsbcchina
去哪儿攻略|com.qunar.travelplan
个性通知极速版|com.getanotice.light
中燃慧生活|com.zrhsh
视频截图|com.equationl.videoshoter
考研倒计时|com.tupo.kaoyan
可儿空气检测仪|com.keer.airdetector
到家美食会|com.daojia
违章查询|com.sohu.auto.helper
极拍|com.paraken.jipai
微信助手|com.sweeperforwechat.android
短信助手（原验证码删除器）|com.rincyan.smsdelete
UC Browser Mini for Android Go|com.uc.browser.en.android.go
HTML（5）编辑器|com.htmlhb
面板顶栏美化主题-和泉纱雾|com.lingweiliang.Hsister.zero
极客天气|cn.com.geeeeker.field.geeeekerweather
国学大师|io.dcloud.H558FF84A
东方时尚|com.dfss.dfssclub
补刀小视频|com.yy.budao
轻松订旅馆|com.expedia.bookings
蜜读|com.wwdx.readwhat
比呀比海外购|com.biyabi
设备信息|com.ty.android.deviceinfo
MAT助手|com.mat.xyj.matxyj
英语背多分|com.eusoft.recite.en
塔塔英语电台|com.tataera.radio
随手拍|com.sina.weibocamera
sqlite编辑器|com.sqleditor7e.tool
魔性表情|com.wangc.face
网速通|cnc.cad.netmaster
试题君|com.hwl.qb
酷狗识曲|com.kugou.shiqu
沙发旅行|com.tenant.apple
快递猫|com.king.crydear
Marvel Clock|com.glgjing.alarm
百度医生|com.baidu.patient
Solar Walk 2 Free|com.vitotechnology.SolarWalk2Free
会动的氢壁纸|com.free.hydrogen.wallpapers
松鼠记账|com.hejia.squirrelaccountbook
面板顶栏美化主题-八重樱|com.lingweiliang.doublecherry.zero
书橱|com.example.administrator.bookrack
纯净答题助手 - 快速搜索答案|cn.hugo.chongdinghelper
PicoVR|com.picovr.wing
简诗|com.wingjay.android.jianshi
MeWoo|androidapp.sunovo.com.huanwei
西南大学开源协会|com.swuos.swuassistant
Magical Winter - Xperia主题|com.sonymobile.themes.magicalwinter
万物起源The History of Everything|com.twodimensions.timeline
Artand|cn.artand.android
大画家|com.everimaging.goart
360帮帮|com.qihoo.safe.remotecontrol
轻加减肥|com.sythealth.fitness
玩电影|com.mofunsky.wondering
广州农商银行|com.gzrcb.mobilebank
到点|com.shuangyue
追书助手|com.aiteio.zhuishuzhushou
大象中医|com.sogou.medicalrecord
手机鼠标|com.example.tongyonban
RTFI-悬浮窗口待办事项提醒|com.xpf.me.rtfi
.finish（测试性能小软件，看你手机能不能完美撑过）|nico.kiss
惠租车|com.huizuche.app
刷屏神器：CoverScreen|com.galaxy.coverscreen
手机号定位|com.bx.bx_daowei
B1ESS for KLWP|b1ess.godb1essicy.pack
python|innovationlabs.python.com
酷云TV|com.kuyun.tv
动物乐园|com.sinyee.babybus.animal
POKER|us.pinguo.filterpoker
搜狐汽车|com.sohu.auto.sohuauto
飞鱼相册|didikee.wang.gallery
360换机助手|net.qihoo.mobilesafe.switchassist
PW品玩|com.pingmoments
Enlightened代码编辑器|xyz.iridiumion.enlightened
火星备份|com.beifen.gj4560
某某输入法|com.moumou.input
酷安开发者控制台|com.targroup.coolapkconsole
猫语翻译器|com.planapps.biansheng
流量掌厅|com.raiyi.wxcs
奇妙梦境|com.inmeapp.dream
现代汉语词典|com.xiaobin.lotsdict
人体穴位图解|com.myapp.li.rentixuewei
Storyboard|com.google.android.apps.photolab.storyboard
超级加速-手机清理加速|com.boost.booster.clean
阅读神器|com.jie.bookreader
西米主题美化|com.nepo.simitheme
OvOy Live Wallpaper|mobi.ovoy.iwp
米粒桌面|com.mili.launcher
蓝天白云视频动态壁纸|com.naturelwp.video.lwp
一折特惠|com.dataoke.shoppingguide.app13058
通知LED管理|com.yyfleo.NotificationLEDManager
A屏福利-全黑背景|tw.song.background
马拉马拉|com.smart_invest.marathonappforandroid
今日热点头条|com.sogou.se.sogouhotspot
DiskInfo|me.kuder.diskinfo
华为主题 Super White EMUI9.0|com.emui.superwhite
花旗掌上银行:Citibank CN|com.citibank.mobile.cn
小小优酷|com.youkuchild.android
media Re.Scan|com.xiaomin.mediares
中国搜索|com.chinaso.so
良品铺子|com.lppz.mobile.android.outsale
GoVR Player|com.mj.govr
FusionAccess|com.huawei.ahdp
话唠图标(圆形版)|com.andy.icon.one
吾印|us.pinguo.watermark
KK浏览器|com.kk.jd.browser
阿里隐私守护:Applock&Vault - Privacy Knight|com.ali.babasecurity.privacyknight
腾讯云叮当|com.tencent.ai.dobby
宫殿笔记|org.savebrain.palacenote
西施|me.tysheng.xishi
热铁盒工具箱|shangzhenyang.rthtoolbox
香蕉打卡|qibai.bike.bananacard
读者杂志官方版|com.fumei.dz
计算器|com.example.ljh99.calculator
DU Clean Master|com.duapps.cleanmaster
截图瓷贴:Screenshot Tile|com.github.ipcjs.screenshottile
Android N 抓猫彩蛋|com.android.egg
爱奇艺TV版|com.qiyi.tv.tw
同步控制所有音量|com.itheima.audiocontrol
AndPods|cn.xiaolongonly.andpodsop
Logo制作|com.psd2filter.logomaker
证件水印宝|cn.shuiyinbao.app.android
微集 - 留下你想看的|cc.iamtu.miniset
二级Office助考手册|com.passoffice
Bing每日一图|com.didikee.bingpicture
快速搜索(文字搜索，图片识别 以图搜图，自定义搜索)|com.hisnstudio.quicksearch
美团拍店|com.sankuai.meituan.pai
xperia尼尔机械纪元主题|com.yourcompanyname.nier
伴你左右|com.lyl.myallforyou
B站封面姬|com.changqin.bilibiliconverfetch
GIF动图制作|com.gifediting.gifmake
多多计算器|com.ibox.calculators
必修|cn.beefix.www.android
快兔出行|com.ekuaitu.kuaitu
Xperia Theme SONY LOGO White|com.jackblack.xperiathemesonylogowhite
翼健康|com.gdhbgh.activity
英语听书|com.tataera.tingshu
公式定理库|top.slantech.gsdingli
Glim图标包lite|com.icons.glim.lite
歌词精灵|com.c4x.lyricdemon
拉姆-Xperia主题|com.twowan.lamu
随机数字|com.zhanhong.RandomNumb
温州银行|cn.wzbank.mobilebank
黄历万年历|com.yiqi.calendar
泡单词|com.paoword.www.paoword
天下游免费版|com.deniu.txyfree
Shelter|net.typeblog.shelter
葡萄生活|com.putao.live
sim导出助手|com.liyi.apps.simexport
Joi播放器|com.wswsl.joiplayer
Spring|com.carlisle.spring
结构大师|com.CDA.StructureMaster
Clean Foggy|se.knowit.mobile.cleanfoggy
K歌助理|com.shuitianyun.kassistant
微冷|net.ohrz.microfreezer
卷狗|com.dataoke.shoppingguide.app581436
质感记录MatLog|com.pluscubed.matlog
企鹅MV|com.tencent.mv
岭南通|com.lingnanpass
移动图书馆|com.chaoxing.mobile.publiclib
SendApp|io.github.skyhacker2.sendapp
挖哇|fm.wawa.music
上篮|com.lanqiudi.news
小转发|com.example.junnan.xiaozhuanfa
粤通卡|com.uroad.unitoll
Inkspace|com.wacom.mate
路人女主-加藤惠 Xperia主题|com.theme.passerbyjiatenghui
芒果旅游|mangocity.activity
宝宝学蔬菜|com.sinyee.babybus.vegetable
美图美妆|com.meitu.meipu
萌宝儿歌大全|com.sinyee.babybus.video
自动换壁纸|cc.kernel19.wallpaper
GIF压缩|com.gxapplab.minigif
SWP4Mi|com.oudi.swp4mi
青岛银行|com.rytong.bankqd
松果倾诉|com.app.pinealgland
精简时钟|com.frank.simplifyclock
Jandan|com.geniusnut.jandan
那年|com.snda.starapp.app.rsxapp
四六级准考证号找回（已失效）|xyz.xinyutian.find_your_cet_number
海豚动态壁纸|com.dolphin.livewallpaper
中读|com.sanlian.zhongdu
苏州银行|com.yt.sz.szbank
重庆银行|cn.com.cqb.mobilebank.per
掌阅漫画|com.motong.cm
图简|com.imsiper.tj
骄傲的便签|com.hong.easynote
每日记-笔记日记本|com.luyun.diary
未闻花名colorful-Xperia主题|com.yayizic.wantheme
华视出行|com.vision.vifi
Material Tools|com.MaterialDesign.messy
新东方|com.xdf.pocket
兔子骑行|com.biketo.rabbit
火星小说|com.duyao.poisonnovel
green - Xperia 主题|com.liwind.lv
Chance|com.chance.ui
拍照翻译|com.mayt.ai.smarttranslate
轻计算器|com.xyznh.calculator
拼图锁|com.by_syk.puzzlelocker
口袋心理测试|com.xinli001.ceshi
分享项生成二维码|cn.imrhj.sharetoqrcode
时光网专业版|com.mtime.pro
美家|com.youwe.dajia
网速流量显示|woniulive.re.nettraffic
翻译输入法|com.yiyun.softkeyboard
微信聊天记录导出|top.drawcore.mmex
数据发送工具|com.maggienorth.max.postdata
九宫格(九宫格构图)|com.github.xiaofei_dev.ninegrid
Hubblo VR Player|cn.vr.hubbloplayer
妹妹闹钟:なでなで目覚まし|jp.interlink.moealarm
快速应用切换:Air App Switcher|com.zuiapps.suite.swift
Gank（干货集中营）|com.github.xiaofei_dev.gank
橘纸通知栏|com.jzcompany1.jzapp
趣背单词|com.uhoper.amusewords
壹笔作文|cn.edusign.yibi.sucai
Lovefit|com.milink.android.air
Hatsune Miku-Xperia Theme|com.sonymobile.themes.machao012
Stubborn Trojan Killer|com.cleanmaster.security.stubborntrjkiller
安卓助手|com.xiaomin.advancedpro
Turbo Download Manager|com.xiaomin.tdmpro
高清10000+壁纸|wallpapers.hd.backgrounds.backdrops.themes
Mount Fuji - Xperia主题|com.sonymobile.themes.mountfuji
全能文件扫描王|com.document.cam.scanner
小世界|world.lil.android
有意思吧|com.chenjishi.u148
华润手机银行|cn.com.hrcrb.mobilebank.per
味觉大师|com.eonoot.ue
新华炫闻|com.cplatform.xhxw.ui
PY_SQL_后台开发_数据库管理|com.yzker.usql
NanoIconPack Sample|com.by_syk.nanoiconpack.sample
kiinii|com.meizuo.kiinii
Timer|com.glgjing.timer
应用锁|com.ushareit.lockit
华为主题（EMUI8.0及以下）-Me（尝鲜版）|com.me.masuku
Microsoft Xim|com.microsoft.fuselabs.dlife
多彩二维码|com.zzapp.tdcode
掌媒V3 for Android|com.palmedia
甘豆影评|io.ganguo.movie
make.believe - XPERIA Theme|com.tenasama.lifewithsony
听筒播放v2|com.specher.earplay
Calendouer(日历, 天气, 电影推荐)|cn.sealiu.calendouer
听听音乐|com.lijunyan.blackmusic
MDiconpack图标包|com.zhuzhu.mdiconpack.android
天猫读书|com.aliwx.tmreader
Яндекс.Погода|ru.yandex.weatherplugin
视频V库|com.video.librarys.huangtx
激萌猫咪桌面宠物|com.dreamtd.kjshenqi
爆点漫画|com.baozou.baodiantv
dosnap|com.xitek.dosnap
多窗口悬浮浏览器|zhao.floatwebview
应用管理器|com.hangox.app.manager
安装器+|com.installer.plus
AD助（住）手【ROOT】|com.qinghuan.noADs
Nekopara Vol.1——Xperia主题|com.vanillaworks.nekopara
怪图制作|com.luoye.fpic
权限图书馆|com.finalweek10.permission.other
Windows 93|com.android.Windows93
新华字典商务国际版|cn.dictcn.android.digitize.sw_gjxhdzd_10010
三星S9朋友圈尾巴|com.tpnet.samsungs8good
国家应急广播|cneb.app
蜂雷|com.fl.activity
小账本 - 记账简洁账簿|pw.hais.app.books
CastBox免费音频|fm.castbox.audiobook.radio.podcast
Floating Player|cn.cyt.floatingplayer
电子发烧友|com.elecfans.activity
腾讯时光 - 朋友圈发长视频照片配乐神器|com.tencent.ipai
HashChecker - Hash 值计算+输出|net.rachel030219.hashchecker
极课|com.by_syk.schttable
淘我要|com.taobao.android.need
WPS Office特定机型升级包|cn.wps.moffice_i18n
中国联航|com.jetair.cuair
云视听小电视|com.xiaodianshi.tv.yst
宝宝学ABC|com.sinyee.babybus.abc
故宫展览|net.artron.gugong
咪咕阅读|com.ophone.reader.ui
微搜|com.search.engines
炒饭|tech.xana.lab.fans
Diana Photo|eu.stettiner.dianaphoto
方图标包|fxx.wxf
唤醒|com.frowhy.wake
新蛋商城|com.neweggcn.app
镧·分区挂载|com.xzr.La.mounttool
电竞圈|cn.dianjingquan.android
IA-Xperia主题|com.sjll.iacool
超级学团|com.tupo.xuetuan.student
君何在|com.woc.where
爱说话的奇奇|com.sinyee.babybus.speaking
BDTBBQ图标包|com.pandecheng.baidu.tieba.biaoqing.iconpack
CUTTT-宫格藏图|geziip.com.cuttt
位置定位|com.personalization.location
Saber-Xperia主题-New|com.sjll.sabernew
EMUI主题-XXX|com.xiake.xiaoying
JOIN|com.guduzhengjiu.join
BalticUI - Substratum主题|ya.baltic.subs
微软钉阅:Snap To Pin|com.microsoft.snap2pin
Go - 滚蛋吧首屏广告君|com.kdfly.go
xperia信仰主题|com.yourcompanyname.sony
易按键|xyz.imxqd.clickclick
Trustlook手机杀毒|com.trustlook.antivirus
日记与笔记:journeys and notes|com.microsoft.journeysandnotes
电音鼓垫|com.mvtrail.beatlooper.cn
美日记|com.anybeen.app.diary
你的名字- Xperia主题|com.yourcompanyname.by
安司密信|com.view.asim
立华奏-Xperia主题|com.angelbeats.wantheme
讯飞朗读助手|com.iflytek.readassistant.listenreader
美拍大师|com.meitu.airvid
糖果头像|com.rubao.avatar
一话|com.coverage.text
百度VR|com.baidu.vrvision
质感设计颜色|com.eajy.materialdesigncolor
VoiceShow|com.mythoiocc.occ.voice
带壳截图(创意)|com.mobilephone.Images
图片切割助手|com.andack.croputils
Folding@Home|com.sonymobile.androidapp.gridcomputing
网络工具Network Tool|net.he.networktoolt
GPS实时海拔|com.lexun99.gps
华为主题（EMUI8.0及以下）-CUNEND（测试版）|com.cunend.masuku
视力检测|com.xinmang.visiontest
Epson Print Enabler|com.epson.mobilephone.android.epsonprintserviceplugin
漫画行|com.fanfanv5
KaDa故事|com.hhdd.kada
Moldiv|com.jellybus.Moldiw
校园司令|com.scheduleline
EF图标包 Round|com.mnoodle.eficonpack
安易递用户版|cn.aiqy.demo_public
makeapp|com.magicunicorn.makeapp
PCtoPE|com.zhufuc.pctope
麒麟臂|com.sf.qlb
电影频道|newmediacctv6.com.cctv6
淘工作|com.tbtx.tjobgr
米其林指南|com.suisheng.mgc
面板顶栏美化主题-路人女主加藤惠|com.kouseki.headerpack.megumi
秒懂百科|com.baidu.eureka
儿童编程|com.google.blockly.demo
桌面备忘录|com.kewenc.memodt.activity
指南针|com.liang.lollipop.lcompass
leon-Xperia主题|com.twowan.leon
长沙地铁|com.chinasofti.shanghaihuateng.metroapp
蚊子动漫|com.wenzidongman
Urban壁纸|com.viztushar.urbanwalls
HSBC汇丰银行|com.htsu.hsbcpersonalbanking
Power Light|com.lionmobi.flashlight
分钟视频|com.freshvideo.android
PaletteSummer|com.fotoable.palette.summer
GearIconX2018|com.samsung.accessory.beansmgr
背包吧-旅行计划|com.jianlv.chufabauat
呼噜兔|cn.tuwan.sleep
图片混淆|com.xyznh.imgencryption
省电动态壁纸|sysinfo.wallpapers
哈尔滨银行|com.yitong.hrb.people.android
悠悠|com.uu.uunavi
没有灵魂的手绘图标包|com.duo123.nosouliconpack
Shot On X|com.qingyu.qcamera
BmapLite|me.gfuil.bmap.lite
魔术先生|com.moshu.phonelive
小蚁微单相机|com.xiaoyi.mirrorlesscamera
酷狗KTV|com.kugou.kugouktv
HelloH5|io.dcloud.HelloH5
Gesture(手势导航)|com.omarea.gesture
番茄打卡|top.glimpse.tomatoplan
人工智能-图像识别|kbdance.tensorflow.ai.imageclassify
大影家|cn.com.canon.darwin
Day One|com.dayoneapp.dayone
微约日历|cn.com.vxia.vxia
小米助手|com.xiaomi.mitunes
V+|com.duv.example
常客|com.changker.changker
115组织|com.yyw.cloudoffice
Word2art|com.word2art.wordart
Soda苏打|cn.com.soulink.soda
通话记录伪造|com.zhanhong.calllogfaker
布丁相机|com.tencent.funcam
面板顶栏美化主题-崩坏|com.lingweiliang.BOOM.zero
来电拦截|com.callend
提醒一下|sterbenj.com.simplenotification
千维单位计算器|com.lineying.unitconverter
Facein|com.cm.photocomb
新房装修|com.to8to.wireless.to8to
公式宝典|com.kk.formula
4shared|com.forshared
越野e族|com.fblife.fblife
Bandwagon VPS|com.sukaiyi.bandwagonvps
南方人物周刊|nfpeople.phone.com.mediapad
微软小英口语大师|com.microsoft.mtutorclientandroidspokenenglish
Lion Locker|com.lionmobi.ezlocker
全民广场舞|com.simtrons.dance
便签|com.bq.zn
狗管家|com.fdog.attendantfdog
MikuTap - 通过点按来让Miku发出可爱的声音|at.rbq.mikutap
一句|com.mwf.yige
猎聘校园|com.liepin.xy
雅虎|com.yahoo.mobile.client.android.yahoo
对白 - 学说话沟通技巧|com.xiya.duibai
读览天下|com.dooland.mobilefordooland.reader
郑州银行|com.zzbank.mobile.bank
禁音|yyc.jy
百科解密|com.hudong.baikejiemi
深圳居住证|com.xinghuo.szjzz
猥琐萌小表情（重制降噪）|weisuomengjiangzao.com
影搜|com.smunans.moviesearch
权限检测|com.imoblife.permissioncheck_plugn_in
百度阅读Pro|com.baidu.yuedupro
AIDE NDK Support|com.aide.ndk
GIF制作|com.vavapps.gif
VR世界|com.gevek.appstore
氢默认图标包|com.oneplus.iconpack.h2default
炫光酷安 - 绿色版 - CM开机动画|com.ckylin.shinecoolapk.green
海豚睡眠|com.het.sleep.dolphin
萤火虫睡眠|com.boohee.sleep
读点历史|com.yidian.history
畅呼吸|com.smartisan.smarthome
暖心理|com.chocolate.warmapp
Feeder|com.yooooex.feeder
故事会|com.storychina
牛班|com.newband
英语达人|com.mango.englishtalent
简客|cn.poco.janeplus
易悬浮|com.dospyer.backbutton.free
Resplash|com.b_lam.resplash
企鹅汇图|com.tencent.easyearn
和讯外汇|com.hexun.forex
JO鸡尾酒|com.smarthito.smartmixer
WanAndroid|com.example.thatnight.wanandroid
child of light - Xperia主题|com.liwind.childoflight
Will|com.zuibon.zuibangai
华为主题逆风 EMUI8.0|emui.en.com.wind
HTC Ice View|com.htc.iceview
屏幕小工具|com.zhanhong.screen
便签|com.example.moodwhite.notes
miku深海少女Ⅱ - Xperia主题|com.miku.yun.xperia
山笔记|com.montnote
暁美 ほむら-Xperia主题|com.twowan.akemihomura
面板顶栏美化主题-时崎狂三|com.lingweiliang.clock.zero
萌爪医生|com.wecarepet.petquest
一猫汽车|com.emao.autonews
灯儿护眼|com.messy.deng
稀客地图|com.ckditu.map
爱优漫|com.comic.iyouman
MOJiTEST: 日语能力考试JLPT专用背词|com.mojitec.mojitest
第一VR|cn.net.firstvr
元素周期表深度解析|info.torapp.pt
简单清单|com.crabandwhale.lightlist
酒花儿|com.jiuhuar.android
通知管理|com.imoblife.quietnotification_plugin
微软云剪贴板OneClip Beta|com.microsoft.oneclip
文字表情制作器|com.ishare20.textemoji
360安全扫码|com.qihoo360.safescanner
猿读 -- Github 项目离线阅读工具|com.didikee.openresoucereader
996ICU|com.youngpower.a996icu
见字如面|me.myfont.meet
缤纷高中英语|com.binfenyingyu.gaozhong
指南针|compass.skit.vip
雅虎Livetext|com.yahoo.arrow
云舒课表-MD风格课程表|top.itning.yunshuclassschedule
星光地球|com.earth.free.lwp
xperia 钢琴女孩主题|com.bansheealex.xperiapinao
记账助手|com.chenupt.money
自定义分享|com.androlua.qqfenxiang
简乐|com.jmusic
手机银行|com.iss.weihaibank
家在深圳|szhome.bbs
必应美图|cn.vove7.bingwallpaper
FullScreen|com.gjf.fullscreen
企业手机银行|com.icbc.wapc
Auto Draw|com.staker.bygoogleweb.autodraw
我的信-原妖妖短信助手|com.lazymc.smstoemail
扫一扫-努比亚提取版|cn.nubia.scanner
Glim黑暗图标包lite|com.icons.dark.glim.lite
医学图谱王|com.medicool.mapking
找翻译|cn.com.gtcom.ydt
XSmart小米手环闹钟|xtracer.xsmartalarm
历史上的今天|com.todayonhistory.toh
洪恩故事|com.ihuman.story
图样单词|wordremember.hxx.com.remember
有票儿|com.tc.tickets.train
xperia黑变色主题|com.yourcompanyname.z5
查查公积金|com.rong360.app.cc_fund
速看视频|com.tencent.synopsis
OneTapDoze|com.jasperhale.onetapdoze
WannaSister|android.xiaolan.WannaSister.tool
弹幕消息 （悬浮球手势，音乐控制，Dock）|com.journeyOS.edge
时间|com.shijian
JRS体育|com.johns.jrssportlive
私家藏书|com.bumice.privatelibrary
口袋记账本|com.koudai
照明|io.github.xtvj.flashlight
冻住（新包名）|me.zheteng.android.samsungevil
哒哒天气闹钟|com.dadawh.alarm
逸记|com.angding.smartnote
初中学习助手 - 方程式配平、质数判断、非质数分解（短除）、三点求抛物线 & more|com.gardilily.jhsmar
Mathematics Rational Blue - Xperia™主题|com.highlight.novatsuki.mathmatic
尘埃清理|com.dirt.app
购车通|com.tencent.qqcar
エミリア-Xperia主题|com.twowan.aimiliya
SONY UXP - Xperia Theme|com.tenasama.sonyuxp
趣皮士|com.tripsters.android
西安银行|com.yitong.xian.mbank
AnDock|com.joeapp.dock
BlueDroid|com.ckylin.bluedroid
努比亚阅读|com.chaozh.iReaderNubia
折疯了海淘|com.vanwell.module.zhefengle.app
得图趣梦|com.detu.vr
y3 for klwp|y3.kustom.pack
买啥|com.duoshoumm.maisha
天津地铁|com.bwton.tjmetro
S8主题 - Samsung TouchWiz|com.sec.android.theme.heyixunanguoS8
网易新知|com.netease.awakening
vivo摄影|com.vivo.symmetry
和风xperia主题|com.yourcompanyname.qian
邮政EMS|com.kun.ems
天使挂号|com.zhealth.health
学术格子|com.quickwis.academe
前任博物馆|com.gos.exmuseum
颜色转换Colorgex|com.cwfei.colorgex
每天读点诗歌|com.xcz.modernpoem
人生|cn.yotaku.life
自适应圆形安卓O图标包|com.peach.icon.adaptive.round
小屏保|liang.lollipop.ldream
妙笔汉字书法|com.zxy.writing
xperia半透主题|com.bansheealex.xperiamd
看荐|com.cn21.android.news
灵犀浏览器|sogou.mobile.explorer.streamline
菁优数学|jyeoo.app.math
爆笑姐夫|com.gif.baoxiao
HT浏览器|cn.hunto.HTBrowser
SuKP|com.six.suKP
搜狐邮箱|com.sohu.mail.client.cordova
蓝牙信号监测|me.kevinvista.bluetoothscanner
推酷HD|com.tuicool
网易游戏助手|com.netease.gameservice
味他菜谱|com.yufan.flavourhim
XPERIA™ Toucan Theme|com.sonymobile.themes.toucan
Zootopia-Xperia主题|com.twowan.zootopia
宝宝出行安全一宝宝巴士|com.sinyee.babybus.travelsafety
三毛游|com.iznet.thailandtong
九江银行|com.yitong.mbank.jjccb
小镜秀秀|com.panxsoft.xiaojingxiuxiu
飞嘀打车乘客|com.miu360.feidi.passenger
守望先锋联赛|com.blizzard.owl.cn
lighticons霓虹图标包|com.why102822.lighticons
暴风体育|com.sports.baofeng
城市公厕|com.findsanitary
守望先锋OverWatch-面板顶栏美化主题|com.Aro.headerpack.ow
NBA赛场|com.libowei.nba
奇幻云VR|com.qihuanyun
智能悬浮球|com.cying.floatingball
生日助手|cn.sleepycoder.birthday
图标双击唤醒(仅支持三星7.0)|com.smileide.aod_lide
炫舞小灵通|com.tencent.gamehelper.xw
TC复读机:tc.audio|com.toughcookie.tcaudio
腾讯校猿|com.tencent.PmdCampus
星极定位打卡|com.zczm.daka
卡片备忘录|me.pqpo.cardmanger
猎豹二维码:CM QRCode|com.cleanmaster.security_qrcode
迅雷上行加速|com.xunlei.vip.sxjsq
坚果时钟|com.smartisan.wirelesscharging
天机智讯|com.zhisou.wentianji
守护者|com.liang.lollipop.lreader
GIF搜搜|com.cn.shuming.worldgif
AppMaster|com.ccmt.appmaster
Concept Dream - Xperia™主题|com.highlight.novatsuki.conceptdream
Chrome搜索引擎|cn.silen_dev.chromesearchengineer
iCode|com.iCode.Box
4399游拍|com.m4399.youpai
Jx3-面板顶栏美化主题|com.Aro.headerpack.jx3
doge图标包|com.doge.iconpack
送水到府|com.nongfu.customer
360帐号卫士|com.qihoo.quc.msec
民乐调音器|com.soundmaster
吐槽 HD|moe.hanamaru.tucao.hd
艺术字转换YSZ|net.yunqunzu.aft
Sketch Pi|com.sketchpi
泛见志|com.fjz.app
文本朗读|com.x7890.textspeaker
天气预报|com.tianqiyubao2345
烽火|com.chengning.fenghuo
拍医拍|com.paiyipai
AssistiveTouch|com.cpf.assistivetouch
蕾姆-xperia theme|com.yourcompanyname.leimu
文件浏览器|com.scavengers.apps.filemanager
荣耀畅玩手环|com.huawei.aw600
剪贴板守护|io.github.deweyreed.clipboardcleaner
AirDebug|me.yourbay.airdebug
拜仁慕尼黑|cn.fcbayern.android
Worktile|com.lesschat
拆字|com.woc.chaizi
勾践|tysheng.compress
简约氢壁纸|com.feipeng.mywallpaper
米舒翻译(维汉智能语音翻译)|translate.xuru.hash1
BLE蓝牙调试工具|com.xyf.bletool
熊猫频道|cn.cntv.app.ipanda
屏幕常亮 KeepLighting(保持亮屏)|com.singkarchiang.widget.keeplighting
微软自拍|com.microsoftselfie
三只松鼠|com.szss.haigou
Markdown手机版|culosic.mdpocket.android
广东联网售票|cn.focusspot.nanyuetong
喷图标包|com.pen.iconpack
兰州银行|cn.com.lzb.mobilebank.per
知了收藏|com.kingstudio.westudy
中国食药监管|com.hxzk.android.hxzksyjg_xj
测网速大师|com.novv.speedmeter
CNode社区|org.cnodejs.android.md
TOS 3D Launcher|com.tos.launcher
生活清单|com.eleven.app.shoppinglist
面包旅行|com.breadtrip.trip
小白单车|com.baicycle.app
视频壁纸|com.xq.mp4wallpage
易开发|com.wrbug.developerhelper
Starth必应壁纸|me.liaoheng.wallpaper
云盘万能钥匙|com.Jshare.YunPanKey
米5助手|hk.xhy.xhyutils
箴言|lemon.pear.maxim
DUDU|com.yueke.astraea
相声小品精选|com.app.xsxpjx
Oblatum图标 Lite|com.oblatum.iconpack.lite
QpayMM|com.wokee.qpaymm
济宁银行|com.iss.jiningbank
路由器控制器|com.jimzjy.routercontroller
Equa 化学方程式助手|com.iraka.chemeq
唐诗三百首|com.kk.poem.ts300
4399爆笑一刻|com.m4399.biule
猎豹闪传:Snap Share|com.cleanmaster.snapshare
氡·未响应|com.jakting.nr
五笔查|com.shengdoushipp.wbquery
白开水悬浮助手|com.skkk.easytouch
Nevolution X|com.oasisfeng.nevo.ext
网页刷新器|ttclub.interesting.shuaxin
iMoney|com.clover.imoney
快搜索|com.quark.search
心が叫びたがってるんだ。-Xperia主题|com.twowan.heart
美肤家|com.ilikelabsapp.MeiFu
时光蛋|com.janestrip.timeeggs.galaxy
网易红彩|com.netease.lotterynews
电视家视频|com.fanshi.tvvideo
薄荷浏览器|com.mi.globalbrowser.mini
米公益|com.migongyi.ricedonate
手机百事通|androidc.yuyin
随手翻译官|com.musjoy.translator
地狱少女-Xperia主题|com.ai.wantheme
OralB|com.pg.oralb.oralbapp
字加|com.founder.typefacescan
Selfissimo!|com.google.android.apps.photolab.selfissimo
蜜蜂停车|com.chmtech.parkbees
八神太一-Xperia主题|com.twowan.yagamitaichis
Xperia™樱花主题|com.anjuinami.spt
音巢音乐|com.xilu.wybz
冬日中医|cn.idongri.customer
Bluecoins|com.rammigsoftware.bluecoins
Adobe Fill & Sign DC|com.adobe.fas
点呀点|com.dianyadian.personal
Activities|com.cunnj.activities
联通电视+|com.fortune.mobile.unitv
绝地求生手游社区|com.tencent.gamehelper.pubgm
搜狗输入法 格力定制版|com.sohu.inputmethod.sogou.geli
东方project-header主题|biqiu.renwu.touhoustyle
中华美食|com.sinyee.babybus.food
一键锁屏|com.zzz.lockscreen
乐视一键换机|com.letv.euitransfer
在乎健康大众端|com.remind.zaihu
音乐信息悬浮窗（直播必备）|com.musicInf.floatWindow
假装卡住|com.stuck.s
蓝牙工作站|com.hz.bluetoothstation
转至锤子|com.smartisanos.mover
Bridge帮助分享|moe.shizuku.bridge
QUICK : 备忘录 & 笔记本|com.humanhelper.forhuman.quick
哪吒看书|com.neusoft.neuchild
水印相机大师|com.stickers.watermarker
呼呼|com.nevil.simpleautocall
图片识别|com.example.Tupian_shibie
你噪吗|cn.ixima.sounddetection
小人书连环画|com.xxs.leon.xxs
日迹|me.zuichu.riji
PS社区:PlayStation Communities|com.playstation.mobilecommunity
HomeTime|com.stv.android.videochat
网易100分|com.netease.k12
Xperia™暖银主题|com.anjulnami.xperiawarmsilver
雅虎通:Yahoo Messenger|com.yahoo.mobile.client.android.im
掌上全本阅读器|cn.zsqbydq.reader
WR助手|knowledge.wrbox
鲸鱼阅读|com.ihuayue.jingyu
米家对讲机|com.ifengyu.intercom
拿铁阅读|com.latteread.android
看点视频|com.kuaigeng.video
二寸证件照制作|com.leqi.ErcunIDPhoto
[UNIQUE] Melancholy - Xperia™主题|com.hls.nivayal.unique.melancholy
大鱼旅行|com.fishtrip.hunter
邮差|me.youchai.yoc
好签|com.nj.wellsign
cnbeta Geek|com.didikee.cnbetareader
百度隐私空间国际版:DU Privacy Vault|com.szipcs.duprivacylock
Base64编码器|com.zhanhong.base64
通知栏背单词|com.kewenc.noti
双击状态栏锁屏|com.doubleclick.locker
广州银行|com.gzbank.mbank.externalpk
必美图|com.xcn.bingpicture
SlideshowLab|com.btows.moments
xperia deemo theme|com.ictator.deemo
绿PoPo - Xperia主题|com.iyyyi.popo
复制到剪切板|com.zzz.toClipboard
Xbox 360 SmartGlass|com.microsoft.smartglass
RWBY - Xperia主题|com.yourcompanyname.rwby
Deadline|com.gwokhou.deadline
有记YOKI|com.daniel.youji.yoki
Bompass|com.dxr.compass
PPI计算机|com.tan.ppicalculator
假面召唤器|com.xyfcm.faiz
流利阅读|com.liulishuo.vira
潍坊银行|com.iss.weifangbank
讯飞翻译|com.iflytek.translatorapp
未闻花名ashy-Xperia主题|com.yayiziashy.wanthmem
快否激活器|com.runanjing.activatebenchaf
外教社大学英语词典|com.sflep.idict
中国银行企业网银|com.boc.bocsoft.phone
英汉字典|com.xiaobin.ecdict
画画日记|com.airi.im.ace
颜色集|com.ue.colorful
质感设计演示|com.eajy.materialdesigndemo
AI Photo+|com.smile.ai.aiphoto
MD课表|com.mnnyang.gzuclassschedule
披着被子的滑稽表情包|com.pandecheng.pizhebeizidehuaji.sticker
Pin 设置|moe.feng.nyanpasu.pinsettings
删除最新图片|tech.summerly.thanatos
PChouse|cn.com.pcgroup.magazine
复制拼接|com.github.xiaofei_dev.appendcopy
淘宝头条|com.taobao.headline
局域网精灵专业版|io.github.gofaith.jywjl
随处浏览器|com.suichu.browser
紫金农商银行|com.csii.zijin
万年历极速版|com.youloft.wnl
IP Location|com.rochdev.android.iplocation
多玩图库|com.app.duowantuku
whale - Xperia主题|com.liwind.whale
时尚志|com.onlylady.www.nativeapp
指南猫旅行|com.zhinanmao.app
状态栏下滑屏蔽|com.iraka.collapsestatusbar0
静音|com.gohoc.soundcircle
美天气|com.lesogo.weather.mtq
眼蜜|com.criwell.healtheye
立刻分享|com.qitong.likesharing
Oh!日历|com.huhulab.ohcalendar
花生故事|com.vread.hs
页未央|com.sina.z
SkillTree|cn.skilltree.skilltree
通知贴纸:Notify Stickers|com.thsoft.notification.stickers
BROWNPIC|com.friends.line.android.contents
百草味|com.vipbcw.bcwmall
睡前|com.bedtime.bedtime
SCP移动终端(开机动画)-Substratum主题|com.sub.wh.scpkjdh
英文學習報|com.wordhelpside
保存Now on Tap截图|com.smartjinyu.savenotpic
轻写作|tk.dracloud.writer
骚扰号码识别|com.hanks.library.haomaquery
全景锁屏|com.ngmob.vrlockscreen
数据结构|cn.yunsenlin.datastructures
辣眼视频|com.baidu.hao123.layan
卜吶呐记账|com.a91yuc.app.xxj
HPSprocket惠普小印|com.hp.impulse.sprocket
煲机助手MD|sixh.headset
音量控制分贝仪|com.example.listen
哒铃闹钟|com.jiubang.darlingclock
Drwrcon图标包|com.mojojojodevlabs.drwrcon
WinXP错误模拟|com.bigapps.xperror
南宁智慧人社|com.my.qukanbing
呼噜克星|com.example.user.wave
Just Like|com.aaron.justlike
闪咖|com.tencent.oscar
泡面番短视频|com.xiaohulu.paomianfan
提取线稿|com.xiaomin.xiangao
飞鱼地面站：APM Android增强型地面站|org.jelsoon.android
酷炫多彩开机动画--CM12.1主题|com.youyou475.color
蓝牙定时关闭|com.sq.administrator.bluetooth
圈子|com.moretech.coterie
鱼说|com.fishsaying.android
去哪儿汽车票|com.qunar.bus
京东来点|com.jd.lib.now
索尼科幻主题tri第二版(体验版)|com.yourcompanyname.razer
PlayStation Glacier White|com.jackblack.playstationglacierwhite
UC News|com.uc.iflow
百度圈景|com.baidu.panocam
九库阅读免费小说|com.mengmengda.reader
S Photo Editor|com.steam.photoeditor
高中英语单词|com.csj.highschool
干货集中营|com.bob.gank_client
搞事情|com.surine.todaytodo
米家骑记|com.velomi.app
sony xperia蓝色简约主题V3版|com.bansheealex.bluev3
苏e行|com.bwton.szfreego
XPERIA™ Mass Effect™ Theme|com.sonymobile.themes.masseffect
Dev Kit|com.leo.devtools
HttpInterceptor|cn.darkal.networkdiagnosit
快启|com.yw.android.quickstart
ACG Image Search|net.rachel030219.imagesearch
灰色空间|liang.lollipop.screenhelper
简天气|com.simweather.gaoch
口袋模式|com.wdjhzw.pocketmode
福昕扫描王|com.foxit.mobile.scannedking
日照银行|com.iss.rizhaobank
Supreme|com.supreme.app
百灵语记|com.audiorecorder.lark
唯美写作|com.void_lhf.weimeiwrite2
三星按键灯控制|com.smile.keylight
APP指数|com.by_syk.coolappindex
安兔兔AI评测|com.antutu.aibenchmark
黑照相机|com.chaoserv.d_cam
超级羽|com.appbyme.app159545
美之图|com.mzitu.app
南小鸟Next - Xperia Theme|com.tenasama.minamikotorinext
保持|com.frowhy.hold
360f4复活大法|tros.runanjing.qhmp
宝宝写数字|com.sinyee.babybus.numberwriter
KIKU-XPERIA主题|com.yourcompanyname.kiku
Xperia™ UXP主题|com.anjulnami.xperiauxptheme
鲜知|com.sina.weibo.xianzhi
y4 for klwp|y4.kustom.pack
快影构图相机|com.timeinterflow.formcamera
生日提醒管家|com.weekendsir.birthdays
自动换壁纸|com.hdy.beautifulpic
央视综艺春晚|cn.cntv.zongyichunwan
身份证查询|com.gujin.idcard
诗词大全|com.chazidian.app.shici
渤海银行手机银行|cn.com.bhbc.mobilebank.per
查拼音|com.by_syk.getpinyin
网聚天气|com.aigo.AigoPm25Map
悬浮相册|com.marinesnow.floatpicture
民生小微银行|cn.com.cmbc.newmbank.xw
XPERIA FLUID Theme - 动态壁纸 - 主题 - 酷安专享无聊特别版|com.ga.xperiafluid
翻译盒子-Substratum主题|cn.luojuly.translation
狐 - xperia主题|com.xiaomo.xian.xperia
不要音乐|com.buyao.tv
MIUI9-无界-锁屏|com.wei.lock
手机管理大师|com.apowersoft.phone.manager
乌鲁木齐银行|com.uccb.mobile
局域网文件分享$|top.fols.aapp.socketfilelistserver
即刻|com.hooli.jike
DU Caller|com.whosthat.callerid
英语说|com.android.yys
画+|com.icesimba.motupai
风行视频HD|com.funshion.video.pad
Aha|com.handarui.aha
TOPLIFE|com.jd.toplife
腾讯云助手 -【非官方】|com.akakanch.qcloudmanager2
PKU Runner|cn.edu.pku.pkurunner
360飞传|com.qihoo360.feichuan
what动态壁纸|com.zacks.whatlivepaper
LIFE|me.mglife.android
美团租车|com.lhy.mtchx
没有你的天气|com.weather
手表控|com.watchkong.app
秒表|xyz.imxqd.stopwatch
听音识谱|me.i38.notationcn
PHPlayer|me.pkhope.phplayer
中国视记|com.stx.chinasight
知错错题本|cn.zhicuo.client
问咖|com.baidu.consult
凌健身|cc.leanfitness
文本分割器|com.fuyou.txtcutter
ベアトリス-Xperia主题|com.twowan.bicuisi
屏幕滑尺|com.needjava.screenrulerfree
源音塘|com.mxkj.yuanyintang
小蚁后视镜|com.xiaoyi.car.mirror
游戏比价-纯净版for xbox玩家|com.xboxstore.gamechecker
场景模式（超级声音助手）|com.scenes.s
上橙地铁|com.lingyun.metro
Kindle特价书|com.fadai.kindlebook
短信转发助手|io.dyy.smstomyphone
英语六级单词|com.csj.cet6word
干货|star.iota.gio
农历提醒|gedoor.kunfei.lunarreminder
爱球迷|com.zhengdianfang.AiQiuMi
照片笔记|com.yydcdut.note
图次元|com.lingxiaosuse.picture.tudimension
索尼爱立信怀旧--xperia主题|com.yourcompanyname.sonyericsson
悟空找房|com.wukong.ua
企鹅号|com.tencent.omapp
玩转智能穿戴|tz.xmsh.fwz.com.shtz
探趣|com.remarkmedia.app.kankan
鹭鹭行|com.bwton.msx.ncb
QSV格式转换|com.a4455jkjh.qsv2flv
POPO日本|com.x.animerepo
坚持100天|com.onedream.plan
酷省电|com.khome.kubattery
Project NKU|com.kongx.nkuassistant
旅行者镜头|com.wesafari.travellerlens
华为主题灵动EMUI8.0|com.emui.Immovable
生意如何普及版|com.smallisfine.littlestore
火山视频下载助手|com.maixiaomeng.shxspzs
开发者设置[ROOT]|io.github.xudaojie.developersettings
今天农历|org.sfeto.nongli
adidas|cn.adidas.app
Flexbooru|onlymash.flexbooru
托福Easy姐|com.ezjie.toelfzj
全屏时钟|com.simple.clock
Control Center|com.vietbm.tools.controlcenterOS
隐私保镖|com.qihoo360.mobilesafe.applock
-t Share：分享、复制和缩图|com.tumuyan.t_share
手电筒插件|com.imoblife.light_plug_in
手机令牌|com.wanmei.arc.securitytoken
StarGuardian2017-面板顶栏美化主题|com.Aro.headerpack.starguardian2017
VAIO - Xperia主题|com.yourcompanyname.vaio
由你单车|me.unibike
Tesla Motors|com.teslamotors.tesla
心率测定仪|com.dong.health.heartrate
文字加图片|com.photo.addy
智学网Lite|com.zhixue.lite
GitDroid|com.zpauly.githubapp
锤子商城|com.smartisan.smartisanstore
MD配色参考|com.mdps.zn
汇率换算|com.lql.anyrate
新疆移动手机营业厅|com.xwtec.xjmc
小说阅读网|cn.xs.reader
企鹅看看|com.tencent.videopioneer
导眼|cn.silence795.wanmamovies
AndroLIDE|com.androlide
PS视频:PlayStation™ Video|com.playstation.video
PCtoPE(旧版本)|com.zhufu.pctope
APK Kit|com.github.ghmxr.apkextractor
音标小助手|sr.daiv.phonetics
提醒 Reminder|com.outlook.healthyapps.reminder
清理者|com.shl.clean.master
密码记录器|cn.dxbtech.passwordkeeper
位置流量套餐|com.cmcc.locationplan
净网浏览器|com.brower
猫咪xperia主题|com.yourcompanyname.neko
索尼爱立信怀旧二版--xperia主题|com.yourcompanyname.sonyericssonv2
街舞中国|com.csda.csda_as
装X语音播报|com.rair.xvoice
WShuffle|live.a23333.wshuffle
谷熊|com.idbear
柔记|com.royole.rydrawing
二次函数图像|com.mycompany.zbiao
运动测速器|com.liyi.apps.speedmeter
鹿目まどか-Xperia主题|com.twowan.kanamemadoka
果仁相册|io.zhuliang.pipphotos
情侣课程表|cn.sharepeople.curriculum
看点视频|cn.takevideo.mobile
水木说|com.smthchat
新浪星座|com.sina.sinaastro
S2TDroid TXT繁简转换|com.npes87184.s2tdroid
域名IP查询|com.zhanhong.urlip
箱子|com.rstsysui.s0ptq.rstsysui
轮流唤醒|net.npofsi.tool.awakeactivity
设备信息|com.zhanhong.deviceinfo
美着呢|com.meidaojia.makeup
随译|com.zoneyet.voicetranslate
Meizu See|com.vkei.vservice.meizu
大佬搜书|com.ch.dalao
免费小说|com.zhangyue.iReader
光之子xperia主题|com.yourcompanyname.childoflight
Quick悬浮球|com.assistive.quicktouch
DU Antivirus|com.duapps.antivirus
360连回家|com.qihoo.safe.connect
英傍语境单词|com.lerni.memo
Cam0.618|com.milier.camera618
Minimal Geometric图标包|com.samymarboy.theme.minimal.iconpack.geometric
易排版|com.anybeen.app.article
高频发生器|com.messy.inxx
HWMonitor PRO|com.cpuid.hwmonitorpro
日常-Xperia theme|com.jujueluanma7.xperiatheme
文件夹清理|TIIEHenry.DIR.CLEANER
三星智能相机应用|com.samsungimaging.connectionmanager
指定赫兹 - 掏耳朵吗？？|leo.sx.hz
脸脸|cn.dface
易行|cn.etouch.etravel
闪电健身|com.magmeng.powertrain
Liven Wallpaper Live|com.skytrend.liven.livewallpaper.fx
蓝湖|com.bxzz.bluelake
天津银行|com.csii.tianjin.mobilebank
夜间模式 - 免费无广告,调色温,防蓝光,省电护眼/夜间屏幕,夜景模式|com.tool.nightmode
时间映射|com.timemap
玩Android|com.wan.android
Bing日图|com.androidluser.bingpictures
天天码字|net.example.administrator.dailywritingfortest
Aris帮助文档|com.doger.arishelp
脑洞|com.codingending.mindlib
米柚壁纸|com.xiaomi.wallpaper
应用备份还原经典版|mobi.usage.appbackup
施工计算大师|com.CDAStudio.ConstructionMasterAndroid
结构大师HD|com.CDAStudio.StructureMasterHD
天天快报大字版|com.tencent.readingplus
车生活查违章|com.btbo.carlife
简氢浏览器|weihuagu.com.jian
网易prpr动画|com.netease.prpr
财新周刊|com.caixin.weekly
大头工具箱-视频处理-转GIF|yyc.dt
你好银行|com.njzx.home
CameraScan|Zerocheng.CameraScan
Xperia Theme Nintendo Switch|com.jackblack.xperiathemenintendoswitch
ModPlayer|com.specher.modplayer
Songs|com.design.wen.listenmusic
DU Cleaner|com.duapps.cleaner
浑沌VR|com.hzvr.hzplayer
自学酷|com.zixueku
节拍相册|com.xvideostudio.tapslide
时间日志|me.liujia95.timelogger
IconX图标包|com.mbdev.iconx
熄屏快写Screen Off Memo - 笔记记事三星|com.heyixunanguo.screenoffmemo
简影|august.lesincs.simplefilmreview
发现值得买|com.kiees.android
联想家庭云|com.lenovo.livestorage
微信透明壁纸|com.renchuang.weixinbizhi
超级计算器（无广告）|com.example.sbreak.myxyz
港铁|com.mtr.mtrmobile
FFmpeg命令列|org.magiclen.ffmpeg.cli
VR播播|com.bananavr.vrplayer
朝阳群众|com.netposa.cyqz
宝宝捉迷藏|com.sinyee.babybus.hideandseek
卡片天气|com.gaoyunfan.cardweather
A6天气|com.zzapp.a6tianqi
漫威-索尼xperia主题|com.yourcompanyname.marvel
杭州地铁|com.dtdream.hzmetro
Android面试题|com.wuxl.interviewquestions
小猪佩奇-Xperia主题|com.jinxmizhou.peppa1
玩转地铁|com.hskj.palmmetro
聪明屏幕过滤|com.w.screen_f
厦门银行|com.csii.xm
易打工|com.zrlh.llkc
同城追书|com.aoma.local.book.activity
简单通知|com.example.drcw.tongzhi
去日本|com.gojapan.app
空调万能遥控器加强版|com.seecva.estwca.bwczear
兴业企业银行|com.csii.cib
大学图书馆|com.xuzhipeng.superlib
HduIn在杭电|cc.redhome.hduin.android
人形电脑-最强小学生挑战赛|com.monanthes.endlessmath
丸子|com.iwanpa.play
罗小黑战记-Xperia主题|com.yourcompanyname.luoxiaoheizhanjizhuti
进制转换|com.Amanda.Transformation
照片加密相册|com.didakeji.jiami
LED灯板(LED Board)|wjh.dcloud.H5DE116C0
烟台银行|com.iss.yantaibank
乐次元|com.letv.android.young.client
扫描大师|com.ligan.masterscanner
急救手册|com.rair.ecc
抹茶美妆|com.yunyaoinc.mocha
AnyLauncher：任何应用都能做启动器|com.tumuyan.fixedplay
太合音乐人|com.taihe.musician
测速学徒|com.example.tyr.netspeed
老子占内存|com.huaji.memorykiller
悦动圈Pro|com.yuedong.rejoice.huawei
酷狗音乐歌词批量转换|com.krc2lrc
文曲星安装器|andseven.wqxinstall
占位符|com.myderta.none
小小目标|com.guaiguaide.present
ClassyShark(APK分析)|com.google.classysharkandroid
翻译助手|com.CT.fanyi
一图壁纸|cn.haotowm.oneimg.client
AEX壁纸|org.aospextended.aexpapers
安全客|com.qihoo360.bobao
Garras|com.iuuaa.img
PowerBI|com.microsoft.powerbim
中文书城|com.chineseall.singlebook
卡卡韩语|com.kakakorea.word
多功能清单—不止于任务清单|me.shouheng.omnilist
画什么像什么|wang.kahn.alike
Piece 课程表|com.github.aoramd.piece
有干货|me.bakumon.ugank
和弦吉他:吉他模拟|com.mvtrail.realclassicalguitar.cn
复制分享|com.perqin.copyshare
Surfy Browser|com.outcoder.browser
尽阅|com.agoni.freeread
菠萝觅|com.kuping.android.boluome.life
微文阅读|cn.crane.application.wechat_ariticle
二维码快扫|com.sduwh.qrcodeScanner
雅虎体育:Sports|com.yahoo.mobile.client.android.sportacular
炫光酷安 - CM开机动画|com.ckylin.shinecoolapk
Adobe XD|com.adobe.sparklerandroid
长江大学图书馆|cn.edu.yangtzeu.calis.yangtzeulibirary
小黑屋|me.eagzzycsl.darkroom
Win10MetroDemo|com.xpping.windows10metro
控制|com.frowhy.dominate
青果摄像机|com.netease.camera
爱柚壁纸|com.selfimpr.pomelo
行业微信号|com.windows5.www
你的名字 - xperia主题|com.c.yourname.xperia
OMFG Lite_敲可爱小面包！|com.sftmi.omfg.lite
随身差旅|com.hmammon.chailv
Android Ultimate|me.arulnadhan.androidultimate
GPS相册|deified.com.gpspicture
高手电竞|com.gogosu.gogosuandroid
日记云笔记|com.rubao.diary
Squircle图标包|grives.squircle.iconpack.free
XperiaEarDuo|com.sonymobile.hostapp.xea20
文本操作|com.layout_alittlemc.textdo
APAS|com.freetymekiyan.apas
读我吧|cn.devifish.readme
爱与平和 - Xperia Theme|com.tenasama.ohloveandpeace
图友|com.jianjian.changeim
天翼云|com.ctg.itrdc.ecloud
滴滴配送|com.didi.rider
录屏助手|com.sszhen.recorder
云课|com.yunke.android
备忘录|com.utangic.memorandum
微相机|com.xvideostudio.vcamera
词条助手|com.androlua.baidubaike
DU安全:DU Security|com.baidu.dusecurity.hydrogen
快速启动|com.mh.faststart
悟空考研|com.tupo.wkkaoyan
频果单词|com.pinguo.word
高德实时公交|com.autonavi.realtimebus
白板 - 简易画板工具|me.hisn.whiteboard
Klwp live widget|klwplivewidget.kustom.pack
马上办|im.yixin.qiye
iNd播放器|com.leensamziv.indplayer
网易哒哒|com.netease.dada
XPERIA--伪OREO主题|com.nroad.oreo
讯飞电视助手电视版|tv.yuyin
sony-xperia 黑变色主题V2|com.bansheealex.black2
东方体育|com.songheng.eastsports
百度手机卫士国际版|com.baidu.mobilesecurity.intl
下饭视频-王卡免流量|com.tencent.xiafan
音乐键盘|com.lyd.voicekey
企业银行|com.cmb.ubank.UBUI
夏目友人帐-Xperia主题|com.xiaobi233.xiamuyourenzhangzhuti
铁路伴侣|com.winsion.inception
XPERIA™ Spring Theme|com.sonymobile.themes.spring
Adobe Comp CC|com.adobe.comp
变美志|com.meitu.zhi.beauty
贝壳习惯|com.xiaozi.custom
颜色库——App配色方案|com.staker.peise
COC|com.equationl.coc
青苔|com.cybeye.qingtai
多多小说|com.duoduo.novel.read
音乃木坂物语 - Xperia Theme|com.tenasama.memoriesofotonokizaka
奥多比创意:Adobe Create|com.adobe.dpspubs.inspire
Gifitii|com.gifitii.android
风迷频道|com.baofeng.fengmi
StepBeats|com.enjoymusic.stepbeats
离腕响铃|live.a23333.wring
石田大和-Xperia主题|com.twowan.ishidayamatos
崩坏3动态表情包by Seseren（已弃坑）|honkai.impact.seseren
冰与火维基|com.southernbox.infwiki
MINE|icartoons.cn.mine
易剪|name.gudong.easypaper
贵州银行|com.csii.guizhou
宋词三百首|com.kk.poem.sc300
图文相册|com.anybeen.app.story
拉卡拉商户通|com.lakala.shanghutong
In家|com.zhenpin.app
睡个好觉|tuya.com.sleephelper
宠物狗大全|top.slantech.voicedogs
阅懒|com.yuerun.yuelan
图说|com.egguncle.imagetohtml
HstopApk|tc.mycompany.com.hstopapk
CAD手机看图|com.gstarmc.lite
Free护眼|com.yjl.feyepro
塔塔语文|com.tataera.ytata
Google涂鸦集|party.danyang.doodles
图糖|com.timelement.xe2
文件 Fast-支持正则表达式的文件搜索|cuily.filefast
Zebro White图标包|com.princeabid.zebrowhite
菁优高考|jyeoo.app.gkao
哔哩封面2.0|org.biantan.bilifm
画板|com.drawingboard
同程攻略|com.tongcheng.diary
民生直销银行|cn.com.cmbc.dbank
中山大学|com.lantu.MobileCampus.sysu
LynkCo|com.lynkco.customer
随读|com.freedom.read
WanAndroid|com.ce.wanandroid
360小说|com.qihoo.appstore.bookstore
忆年|com.github.postsanf.yinian
简约取色|com.blink.dagger.justcolor
SIF动态壁纸|tech.niangaodev.siflivewallpaper
昆仑银行|com.chinamworld.klb
XPERIA黑化主题 - Xperia主题|com.budao.heihua
读个小故事|andoop.android.amstory
捷毛|com.quick.feihua
矢泽妮可Next - Xperia Theme|com.tenasama.yazawaniconext
子剑影视|com.zijian.vip
在一起|com.taotie.circle
PDC图标包 Lite|com.pandecheng.iconpack.lite
松果生活|com.lifeweeker.nuts
英语说|butian.englishsparring
趣拍|com.duanqu.qupai
AA逆向助手|aenu.reverse.ui
狸猫相机|com.ss.android.eyeu
北京时间|com.btime.bjtime
快捷通道|com.ssding.kjtd
饭团|com.fantuan.onigiri
GetIcon（绘制图标包的神器）|com.air.geticon
圈地|com.quandi.run
讯飞快听|com.iflytek.fastlisten
四月は君の嘘 - Xperia主题|com.yourcompanyname.theme606060
噪音检测|com.zhanhong.noise
小Q相册|com.tencent.weiyungallery
作业盒子小学|com.knowbox.rmrc.student.pk
PP天气|com.neuroandroid.pyweather
AK Cleaner Free|com.nlcleaner
西木野真姬Next - Xperia Theme|com.tenasama.nishikinomakinext
高石武-Xperia主题|com.twowan.takaishitakerus
Iconrain|moe.feng.iconrain
漫画汉化|com.example.m3h
Kana-五十音图不可能这么好背|rekcah1986.kana
天气预报|com.yunxi.weather2
图加|com.tujiaapp.tujia
搜狗导航|com.sogou.map.android.sogounav
考研英语单词|com.csj.kaoyanword
微连|cc.weline
乐视高尔夫|com.lesports.albatross
玩机派|com.nesp.assistant
迪卡侬|com.decathlon.app
黑猫投诉|com.sina.heimao
记忆大师|com.icelee.memorytraining
微跑|com.neusoft.MicroRun.app
FloatText LITE (悬浮文本)|tool.xfy9326.floattext_lite
大料|com.sogou.wxhline
短网址生成|com.dwzsc
阅历|com.orange.yueli
轻语|com.xyznh.textwidget
通知盒子:Notify Box|com.hawk.notifybox
伴伴|com.imbb.banban.android
181818 Xperia夜间主题|com.sjll.grey
春日野穹-xperia theme|com.hybzhl.qiong
淘宝阅读|com.tbreader.android
Qlippie|com.qlippie.www
逆流|com.niliu.activity
歇后语词典|com.kk.dict.xiehouyu
八神光-Xperia主题|com.twowan.yagamihikaris
模型地球|com.liming.astatic
菁优物理|jyeoo.app.physics
西柚大姨妈|com.menstrual.menstrualcycle
荣耀亲选|cn.honor.qinxuan
地震VR体验|com.DH.Test1
Week|com.magnitude.right
脸咖|com.btows.faceswaper
发呆画板|com.fadai.drawingboard
微翻译|com.znwfy
Tea亮屏|com.tea.wakelock
《上古神兽》VR|com.wanchong.tommyxu
简天气|com.alua.weather.app
胡来艺术|com.hoolay.app
XPERIA™ Swimming Theme|com.sonymobile.themes.swimming
西祠胡同|net.xici.newapp
梨！～侦探事务所！Drawer Icon|com.sftmi.py.drawer
火星情报局|com.xfdream.mars
玩美Fun|com.perfectcorp.ycf
多乐电台|com.duole.fm
Android开发干货|com.nilin.developgoods
糖果助手|com.candykk.candytools
DU Tube|com.baidu.Funnypopularvideos
粉萌日记|com.luyun.pinkdiary
μ's的圣诞奇迹 - Xperia Theme|com.tenasama.christmasoflovelive
滴滴商户|com.xiaojukeji.didi.soda.merchant
SIT上应助手|com.example.luhongcheng
矢泽妮可 - Xperia Theme|com.tenasama.yazawanico
天涯头条阅读|com.yslearning.tyreader
魔方志|com.hoge.appryhz9nlmvd
美的空气管家|com.midea.ac.mideaair
本地图书|com.thl.book
清净分享 Clean Share|com.catchingnow.share
117运动|org.zd117sport.beesport
Plant|com.teambition.plant
寻色|cn.semedia.android
便捷下载|com.lcw.easydownload
Touhou Style|biqiu.shenmilu.touhoustyle
PMCAFF互联网产品社区|com.pmcaff.web
发呆便签|com.app.fadai.supernote
私人密码本|com.android.yzd.mima
Base64加密——图片♂文本|com.key.fwz
呼呼收音机|com.saker.app.huhu
城户丈-Xperia主题|com.twowan.gidojous
抑郁症-klwp|dep.tokipukey.kustom.pack
无限WiFi|com.coolway.com.mywifi
简约手电|cc.trv.simpletorch
旧时光-记录生活|com.jiushig.oldtime
白色花 - CM开机动画|com.ckylin.whiteflower
氢Folio图标包|com.oneplus.iconpack.h2folio
All2Download|com.daquexian.all2download
超能Lu|com.zhishan.cosplayapp
腾讯企业通|com.tencent.txeim
传情|com.threewater.chuanqing
魅族手表|com.meizu.watch
飞飞记事|com.feimeng.feifeinote
卡片任务-CardTask|project.radua.cardtask
探记记录|com.liferecord.tanke.liferecord
网速限制|com.liyi.apps.activity.speedlimit
myDiary|com.nexuslink.mydiary
马上吃|cn.com.mashangchi
ScreenShotTile|com.zhangjie.screenshottile
实时天气|com.kuku.weather
外卖帽生成器|com.mz.gxl
?|l.sleeping
靠垫网|com.kaoder.android
iWalk|com.iwalking.main
星空锁屏|com.ofans.locker
GankIo|me.venjerlu.gankio
乐游火车票|com.changxiangtianxia.leyouhuochepiao
表情包生成|com.jxs.bjb
寻路|com.microsoft.msra.followus.app
百记|com.baidu.inote
文本悬浮窗|com.wzzdxsq.tool
西安公交查询|com.fxc.busline
通讯管家|com.netqin.mm
六级Easy姐|com.ezjie.cet6
奥多比青年之声:Adobe Youth Voices|com.adobe.ayv
人人译视界|com.rr.ysj
屏幕时间助手|cn.wxhyi.usagetime
混凝土大师|com.CDAStudio.ConcreteMasterAndroid
网络流量监控|msd.n2g.n3g
太刀川美美-Xperia主题|com.twowan.tachikawamimis
常聊助手|com.ziwenwen.onekeychat
回收哥|com.oxbix.gelinmei
麦田|net.giosis.qstyle.cn
健身教学|com.app.jianshendashi
酷壁|com.my.coolwallpaper
电子书阅读器|com.uhmtech.reader
青果计算器|com.qingguo.calculator
Zoho Writer|com.zoho.writer
飞鸽外卖|com.example.feige
七洲自由行|com.qzmobile.android
美美的新年--xperia主题|com.yourcompanyname.sonypeople
趣相投|com.quxiangtou.release
趣句子|com.qujuzi
Cardlite for KLWP|cardliteforklwp.kustom.pack
深澜校园网登录|xyz.miniliuke.schoolnet
猫锁屏|com.handarui.catlockscreen
Animation+|com.kdanmobile.android.animationdeskcloud
小埋-Xperia theme|com.jujueluanmab.xperiatheme
咿啦看书绘本故事|com.ellabook
指尖乐器|com.example.onepiano
搜有趣|cn.creativept.imageviewer
由我主演|com.loopeer.android.photodrama4android
白噪声:White Noise|com.mvtrail.whitenoise
pinbox收藏夹|com.pinboxapp
绚濑绘里 - Xperia Theme|com.tenasama.ayaseeli
如愿|com.wishes
Alynx 动态壁纸|xyz.alynx.livewallpaper
夜半故事|com.example.ghoststory
Uzumaki Himawari-Xperia主题|com.twowan.uzumakihimawari
必应壁纸|com.pihee.bwp
氢Light图标包|com.oneplus.iconpack.h2light
魅族TV助手|com.meizu.flyme.tvassistant
定时开关|com.adymilk.timertosometings
郑州地铁一官方APP|com.metro.zzmetro
3D万花筒|com.liyi.apps.wanhuatong
凤凰房产|com.ifeng.houseapp
量子笔记|com.wutuo.note
菁优中考|jyeoo.app.zkao
CAD建模号|com.wuweido.cad
译见|com.etres.ejian
记事本|com.bxs.note
日常小菜谱|com.richang.tccd
CE DEV|com.CATCE
How|com.prettyyes.user
围观小视频|com.onlookers.android
说文解字|com.kk.dict.dictsw
大电竞|com.wanrunbo.esports
车来哉|tysheng.sxbus
Dialog?|cc.qpomelo.dialog
MobMax|com.jxs.re
银联迷你付|com.unionpay.minipay.app
鸽子快传Lite|com.smallappteam.wifisharelite
立体声Bluetooth耳机SBH54|com.sonymobile.hostapp.sbh54
秒看|com.yixia.miaokan
KateGay - 搞素材 搞壁纸 全都搞|com.zc.kate.kategay
白色相簿2——Xperia主题|com.vanillaworks.whitealbum2
海立方|com.haier.hailifang
醒来|com.lensent.wakeup
如糖|com.jojotu.jojotoo
国新发布|com.guoxinban.activity
记笔记|zhj.notetaking
玩剧|com.youku.app.wanju
兰州工业学院|com.lanzhougongyexueyuan
书旗小说云版|com.shuqi.aliyun
吐司「已停更」|semem.toast
快速启动|cn.arainfo.quickstart
娱票儿票房分析|com.wepiao.ticketanalysis
Polybox - Xperia主题|se.knowit.mobile.polybox
态客|cn.timekiss.taike
三联生活周刊|com.fumei.sanlian.activity
快乐背课文|com.beikewen.kuaile
百分百HunPercent|com.csming.percent
新浪新闻HD|com.sina.news.pad
清柚老年桌面|cc.qpomelo.launcher
XPERIA™ KONG: Skull Island|com.sonymobile.themes.kongskullisland
坚果云Markdown|nutstore.android.markdown
单车娱乐|us.bestapp.biketicket
座右铭|top.glimpse.motto
二次元图库|com.njk.cyss
增强截图通知|moe.feng.nevo.decorators.enscreenshot
Wallpaper|com.microtears.wallpaper
新城商业|com.xincheng.tv
梦想之源 - Xperia Theme|com.tenasama.musemusicstart
中国银行企业|com.boc.bocsoft
神指计算器|com.tqkj.calculator
联想云盘|com.ledriver
U视频剪辑|com.Usp.jj
剪纸云 Clip Cloud - 剪贴板云同步|com.catchingnow.clipsync
企业飞信|com.cmri.ercs.qiye
简读|com.lianghongbo.jiandu
电脑管理手机ConnectMe|cn.m15.connectme
高坂穗乃果Next - Xperia Theme|com.tenasama.kosakahonokanext
摇一摇切歌|com.fox.next
腾爱医生|com.xinci.superapp4doctor
捷兴卫士|com.zc.jxcrtech.android
创客学院-编程MOOC公开课|com.makeru.farsightckxy
录音机小明|com.dida.recorder
星之守护者 迦娜-xperia主题|com.twowan.starguardianjanna
方块清单|com.xihuxiaolongren.blocklist
东条希Next - Xperia Theme|com.tenasama.tojonozominext
偶家|com.iojia.app.ojiasns
堆叠 Stack Icon Pack|com.itypen.design.stack
帝彬小字体|com.dibin.font
IEVER美课|com.iever
塔塔口语|com.tataera.kouyu
XPERIA Woody主题|se.knowit.mobile.woody
Nekopara Vol.3——Xperia Theme|com.vanillaworks.nekopara3
狗头贴:Dog Stickers|com.epicapplabs.photocollage.dogstickers
Asmms图床-Lite|me.zsxh.asmms.lite
透析记词|com.rotevocabapp
XPERIA™ Cityscape London Theme|com.sonymobile.themes.cityscapelondon
武之内空-Xperia主题|com.twowan.takenouchisoras
密码清除器|tokipukey.pass.cl
西邮游|com.example.xiyou3g.playxiyou
eNote|com.shengxue.enote
死磕|com.shaike.sik
爱小说阅读器|org.cocos2dx.ReaderBook
塔塔读书|com.tataera.dushu
南小鸟 - Xperia Theme|com.tenasama.minamikotori
XyTodo|com.naxy.xytodo
查快递|wang.junqin.chaexpress
必看|com.zhongsou.souyue.headline
汉语字典|com.novv.dictzh
微历|com.spread.wecal
绚濑绘里Next - Xperia Theme|com.tenasama.ayaseelinext
园田海未Next - Xperia Theme|com.tenasama.sonodauminext
V动画|vip.banet.vdonghua
厦门市民卡|com.chinaums.xmsmk
BitMusic|com.sf.BitMusic
东大网关君（东北大学最火的网关登录app）|com.lalala.fangs.neunet
西木野真姬 - Xperia Theme|com.tenasama.nishikinomaki
捕获闪照|cn.yesterday17.fpc
Xperia™ Ear|com.sonymobile.hostapp.xea10
录屏高手|com.jie.record
腾讯企点|com.tencent.qidian
王者快报|com.w.xg
方便卸载|com.tk.convenient.uninstall
觅时|com.youdobetter.metime
术康|com.shangyi.postop.paitent.android
简单天气|xyz.lovemma.weatherdemo
臻助手|com.mobileott.zenassist
附录文艺|com.app.fulu
Lion|com.ruzhan.lion
MOMOPlus|com.immomo.young
微图记|com.tencent.banma
星之守护者 拉克丝-xperia主题|com.twowan.starguardianlux
泉光子郎-Xperia主题|com.twowan.izumikoushiros
电影小分队|com.thisandthat.maomaomjl
文本封印|com.example.administrator.enigma
随口记|com.eonsun.Memorandum
爱途旅游|com.iflytek.tour
3D像素动画壁纸|tyron.pixel
Soldier Game Girls - Xperia主题|com.tenasama.soldiergamegirls
叶子手电筒|com.yezitorch
戈壁之眼|com.neusoft.deyesdemo
女装图标包:Dress Icon Pack|com.epikurprod.dress
摘客|com.hengtiansoft.zhaike
留光|com.myt.savetime
方正稚艺简体|com.fonts.fzzyt
游戏王AR|com.ygoar.ygodad
爆笑黄人|com.baidu.gif
C手册|com.drxs.chelp
菊理-Xperia主题|com.twowan.juli
Wifi优先级修改器（适用6.0下）|com.andack.wifiprioritychangeo
WPS connect|com.wz.wzwpsconne
上海交通|cn.sh.jt.lbs.complex
COLOR™ Theme  Purple XPERIA|com.ga.bepurple2
云犀日历|com.yunxi.calendar
记 - 专注创作|com.kongzue.notes
HTTP Server powered by Apache|com.esminis.server.apache
大圣归来-Xperia theme|com.jujueluanmai.xperiatheme
SuperFinder|com.happybees.digalsearcher
凤凰FM探索版|com.ifeng.discovery
账号密橱|acffo.xqx.accountmanageacffo
手帐|com.color365.hand
译文的书|com.shtph.app.ywds
AR记忆|com.xinghuo.ar_social
走个流程|wang.buxiang.process
書櫥Pro|com.example.administrator.newbookrack
我们是合而为一的光 - Xperia Theme|com.tenasama.musicforever
sony-xperia 美美的新年主题V2|com.bansheealex.newyear2
嗨起|com.showme.hi7.hi7client
简纸|me.oaosj.solidcolorwallpaper
X Edition Saber——Xperia Theme|com.vanillaworks.saberlily.x
飞起来翻译|com.zacks.flyingtranslate
备忘录|com.aiduo.esmemo
Connect2|com.lenovo.connect2
可塑性记忆艾拉——Xperia主题|com.vanillaworks.isla
酷安绿-xperia主题|com.kuan.xperia
Andy英语学习:Andy|com.pyankoff.andy
货币汇率计算器|mvtrail.calculator.currencyexchange
六八表情包|com.pandecheng.liuba.sticker
质感设计配色板|com.theappnerds.materialdesigncolor
厦门地铁|com.luqiao.xmmetro
轻量soso|com.Lightweight.soso
译 Trans|chihane.trans
MT使用文档|cn.jouyo.mt
Nekopara Vol.2——Xperia Theme|com.vanillaworks.nekopara2
千千循环|com.qianqian.loop
Nori图片浏览器|io.github.tjg1.nori
停止运行|com.forcerunning
小地方|com.shanhekeji.smallplace
每日故事|com.mathon.daystory
搜狗哈哈|com.sogou.haha.sogouhaha
催眠助手|com.luyun.insomniahelper
通知过滤：拦截/查看通知栏的推送消息|com.tumuyan.notificationbox
济南公交查询|com.wendy.jnbus
Library Hub For Android|com.androidxy
一直静音AlwaysMute|cn.hunto.alwaysmute
积木|appinventor.ai_907673512.jiugege
LKT模式切换(手动档)|com.kai.lktRun
51壁纸库|com.wclbasewallpaper
欲知手机客户端|cn.kcis.yuzhi
UARun|cn.ua.run
弹窗短信|android.xiaolan.SMS.tool
TT内存清理|com.tt.releasememory
MDUI开发文档|www.mdui.org
轻记账|me.zhouzhuo810.accountbook
好省快报|com.dataoke.shoppingguide.app1186032
凉宫春日的忧郁 - Xperia主题|com.tenasama.haruhisuzumiya
有期|cn.tagux.calendar
钱呢|com.sannio.chargeup
极简·诗|cn.deali.minimalpoem
易跟金|xyz.ezpmt.ezpmt
墨汁|eagle.xiaoxing.expert
联想+|com.lenovo.lenovoservice
糖豆清理（微信）-微信清理加速|com.stone.wechatcleaner.tangdou
满分作文库|top.slantech.mfzwen
应用备份还原|com.app.apkbackup
EMUI主题-GREEN|com.green.xiaoying
AEX非官方 - Substratum启动动画|substratum.earth.aexbootani
A加教育|com.aoshi.aplus
中学单词宝|com.zhimiabc.pyrus
SimpleLauncher|com.brioal.simplelauncher
FontProvider|moe.shizuku.fontprovider
小鸡快充|com.ecc.ka
全球随e聊|com.mobileott.linkcall
趣闻天下|com.hepai.quwen
MagnetVolume(一键媒体静音)|com.magnetvolume
视频动态壁纸:Simple Wallpaper|com.simple.apps.wallpaper.video
BiBi - Xperia Theme|com.tenasama.bibi
JitHub -离线阅读GitHub|com.LingC.JitHub
Aqours 从零到一 - Xperia Theme|com.tenasama.aqours2
易快递|com.jeasycheck
老字号|com.lzhplus.lzh
云犀天气预报|com.yunxi.weather
ABC触宝输入法|abc.apple.emoji.theme.gif.keyboard
温州轨道|org.neusoft.wzmetro.ckfw
古书之美|com.xcz.ancientbooks
文字表情|com.styx.imagetostring
Fly蝴蝶效应|com.hoodinn.fly
Unicorn Xperia Theme|com.yourcompanyname.unicornxperiatheme
boon|com.lyl.boon
有点意思|com.ss.android.essay.zone
周伯通招聘|com.jobtong.jobtong
剑三 - xperia主题|com.xiaomo.san.xperia
Si便签|com.shen.snote
东方头条极速版|com.songheng.fasteastnews
整人碎屏大师|com.yljt.pm25lock.suiping
全局搜索工具|com.search.tool
法语助手题库|com.eusoft.tiku.fr
Free壁纸中心|com.tos.launcher.wallpaperstore
异原谅图标包|com.realityart.greenicon
即刻天气|com.weather.ren.weather
酒笔记|huawei.mossel.winenote
里世界|com.lishijie.acg.video
代码视频/图片|com.myasciiphoto.image.gjl
全民表情|com.soqu.client
海豚记账本|cn.ftoutiao.account.android
照片伴侣:Photos Companion|com.microsoft.PhotosCompanion
传影记小视频制作|com.cykj.chuangyingdiy
中国传统色|com.qienanxiang.color
晚安 World|com.shian.goodnight
李黑|www.boxeloff.com.archaisticsentensemaker
灵朦|com.nimoo.idea
随个缘|com.drogbababa.lution.randomname
匆匆|com.shamine.kuaiqiao.blink
来粘贴|pokon548.comeandpaste
悬浮球|com.sunxiaoyu.imitatekeydemo
狗带翻译|com.godie.English
XPERIA™ Maison Kitsune Theme|com.sonymobile.themes.maisonkitsunetheme
计算器简约版|com.sh.mww.calc
xxReader阅读器|com.shiguanghutong.xxreader
XPERIA™ Cycling Theme|com.sonymobile.themes.cycling
ToddNews|xyz.toddtail.toddnews
百宝侠|com.ykh.bbx
Xperia™伊波杏樹主题|com.anjulnami.pt
大师笔记|com.masterwaynoteYQ
自定义隐藏导航栏|com.zjr.nav_hi
小猫清理|com.easy.kitten.clean
园田海未 - Xperia Theme|com.tenasama.sonodaumi
今日天气|com.ylmf.weather
验证码复制器 - kotlin|tech.summerly.smshelper
悠然一指|com.rz.rz_rrz
图朵|com.tudur
仙剑奇侠传四 - Xperia Theme|com.tenasama.pal4theme
巷陌|com.bluescf.xiangmo
斑马速算|com.fenbi.ape.zebritz
Pixel Copy|com.by_syk.pixelcopy
火车票查询购票|com.libowei.yupiao
二次元壁纸|com.crazecoder.acg.wallpaper
ZKTeco计算器|com.threshold.zktecocalculator
偏见|com.bestmoe.venus
Hotels Combined|com.hotelscombined.mobile
取色器|com.example.black.colormanager
凹凹伙伴闹钟|com.zhentouren.cue
mCare|com.meizu.mcare
ONE图标包|com.deor.oneiconpack
另一个酷安Xperia主题|com.xperia.cooltheme
LivePortraitMaker:男孩|com.zephyo.LivePortraitMakerM
New Year’s Eve - Xperia主题|com.sonymobile.themes.newyearseve
Uker|com.myuker.app
海绵宝宝-Xperia theme|com.jujueluanmal.xperiatheme
老舍全集|com.zhaozhao.zhang.laosheqj
FastLock|com.allen.lockscreen
小泉花阳Next - Xperia Theme|com.tenasama.koizumihanayonext
QQ/TIM/微信唤醒瓷贴|mi.miui.quicksetting
DU锁屏:DU Locker & Lock Screen|com.dulocker.lockscreen
迷鹿音乐吉他尤克里里|com.mintmuse.miramusic
简·历|com.zerosimple.daaays
ZenWatch Wellness|com.asus.wellness
硫化氢-klwp|hts.tokipukey.kustom.pack
屏方Ping2|com.pingfang.cordova
爱合伙创业项目交流和协作|com.aihehuo.app
鹰眼鉴房|com.mjhome
人人漫画家|com.shane.littlecartoonist
九宫格分图|com.lexun99.cut
快捷搜索|com.pandecheng.quicksearch
烤圈|com.cooquan
tt海购|com.newegg.higo
点点租写字楼办公室|com.office998.simpleRent
辈出有读|com.newbeichoo
v快递|com.yomoo.v_delivery_c
LayoutBinder|com.rair.layoutbinder
有读-智能的免费全网小说阅读软件|io.dcloud.UNI811E981
i民大|com.wisedu.cpdaily.znmzdx
lights_theme霓虹灯主题（索尼专用）5.0+|com.yourcompanyname.lights
简黑时钟|com.hm.jhclock
索尼播放器排序纠正|io.github.junyuecao.sonymusicsorter
灵魂图标包one|com.souliconpack.yxs.one
照片备份云相册|com.didasoft.beifen
必应日图|com.yaerin.cooldp
春雨医生HD|me.chunyu.ChunyuDoctorHD
洪恩双语绘本|com.ihuman.book
Animee|com.zhouyuming.animee
有鱼简记|com.jz.njz
Friday|com.bruce3x.friday
vix课程表|com.heiye9.wtbu.course.com
湾区阅读|me.steve.wanqureader
武纺|grade.xyj.com
大鱼海棠-Xperia theme|com.jujueluanmad.xperiatheme
必美图-简|com.Xcn.Bing_Picture_Short
实用剪切板|com.ishare20.fastcopy
Text Text|com.zhihaofans.texttext
喂C|com.vc.app
XPERIA™ Track and Field Theme|com.sonymobile.themes.trackandfield
星之守护者 璐璐-xperia主题|com.twowan.starguardianlulu
Simple备忘录|com.example.notes
中考语文通|com.moyun365.android.zkyuwentong
图片绿化器|com.xyznh.imggreen
高坂穗乃果 - Xperia Theme|com.tenasama.kosakahonoka
懒蛋蛋-Xperia theme|com.jujueluanmak.xperiatheme
KANSOU|star.iota.kansou
REC Remote|com.sony.songpal.recremote
艾特|cn.at.ma
途遥旅行|com.lentrip.tytrip
嘎吱|com.huayushumei.gazhi
XPERIA™ Foody Theme|se.thegreen.themes.foody
福州·三坊七巷 - Xperia Theme|com.tenasama.sanfangqixiang
(旧版本) 偶像大师 灰姑娘女孩 - Xperia Theme|com.ruokong.theidolmastercinderellagirls
皮皮车|cn.xiaomatv.xiaomatv
UDictionary|com.youdao.hindict
XPERIA™ Kitsuné Fox Theme|com.sonymobile.themes.kitsunefox
爱牙|com.sz.order
颜谈表情|com.whj.app.facechat
IDEA|com.jsdroid.idea
星空凛Next - Xperia Theme|com.tenasama.hoshizorarinnext
萌囧|com.mollon.mengjiong
技术船|onlyloveyd.com.gankioclient
美妆助手|com.archcollege.meizhuang
XPERIA™ Team Smurfs™ Theme|com.sonymobile.themes.teamsmurfs
签证照片|com.leqi.VisaIDPhoto
嘿嘿浏览器|com.xiaoyu.application.browser
锁屏猫|com.lazymc.lockmsg
宝骏新能源|com.baojun.newterritory
闲看视频|com.fun.tv.vsmart
红豆|top.huahaizhi.onlyu
移动流量管家|com.ponshine.gprspush
Twobbble|com.twobbble
Haunted Halloween - Xperia主题|com.sonymobile.themes.hauntedhalloween
游戏资讯|com.stx.xhb.dmgameapp
应用菜单:Apps List|com.sc.installedapps
链得得|com.tmtpost.chaindd
船票管家|com.tieyou.android.ship
鸟物语图标包|areeb.scratch.iconpack
天邪安装器|com.tx.et.ed
芝麻万年历|com.mengdie.calendar
红读|com.example.zb.hongdu
Open Design|org.andcreator.andview
Connectoid-Xperia Theme|com.machao44.connectoid
暖心鸡汤|com.w.hotchickensoup
丑媳妇翻译|com.fxc.translator
简记|june.lesincs.simpletodo
EasySports|com.rayhahah.easysports
王小二叫号|com.kobe.quickcall
私人藏书|com.jaaaelu.gzw.neteasy.privatebook
虾米音乐YunOS定制版|com.xiami.walkman
密码管理（二代）|com.password.box
Laravel 5.5 中文文档|com.alley.laravel55documentation
KeepGank.IO|com.jerey.keepgank
禅译|com.fumengji.zenange
长截图大师|com.pczpage.screenshot
玩Android|com.mg.axechen.wanandroid
跪了|com.duowan.orz
小日子商业|com.yunhai.freetime
出外提醒|com.liyi.apps.wifigotip
Most数据加密|com.most.encryption
密空间|com.hitsme.locker.app
掌上重邮|com.mredrock.cyxbs
爱奇艺会议|com.iqiyi.openqiju
银魂-Xperia theme|com.jujueluanmaxin1.xperiatheme
知雨|com.lexun99.zhiyu
OneDay|com.myday.dong.myday
Flatun - 设计灵感|rss.design.studio.flat.flatstudiodesignrss
小度头条|com.baidu.searchbox.info
哈皮|com.tencent.moaudio
速聊-QQ自动发消息|com.Poison.qqsuliao.app
定时开关·蓝牙|adymilk.disablebluetooth
晓运动|com.dongguaren.run
原画梦|com.cutt.zhiyue.android.app38535
星空凛 - Xperia Theme|com.tenasama.hoshizorarin
基础日语口语|sr.daiv.alls.ja
新浪看点|com.sina.sinamedia
NeonInfo|com.earth.NeonInfo
XPERIA™ Valentine’s Theme|com.sonymobile.themes.valentines
BV 体育资讯|com.betvictor.bettingasia
OneMaterial|com.lzx.onematerial
密码生成器|com.zhanhong.randomcode
YY天气|com.runhuaoil.yyweather
手电灯|com.zzz.flashlight
小信拨号|com.shimiao.bhxx
24季私享家|com.fanmei
广发企业手机银行|cn.com.cgbchina.mobilePlatform
隔壁大书|com.locojoy.shucheng
腾讯英语君|com.tencent.aieducation
MIDI制作器|com.midimaker.tool
WidgetNote|com.rousci.androidapp.widgetnote
龙与虎-Xperia theme|com.jujueluanmaa.xperiatheme
看微片|com.pisen.microvideo
全局透明壁纸|com.renchuang.quanjubizhi
简笑话|com.jx.zn
自言|com.ziyan.app
青息|com.linbiscus.cyansleep
论语解读|com.er.book.lunyu
汉字简查|com.github.limuyang2.chinesecharactersdictionary
动漫少女动态壁纸|com.fanart.megumi
给孩子的古诗词|com.hustzp.xichuangzhu.child
简-古风 Xperia Theme|com.yourcompanyname.xperiatheme
快读书|com.smart.kuaidushu
我全都要表情包|yyc.app.aeubxxrl
MagnetUrl(磁贴打开网址)|com.magneturl
NeatQR-二维码工具-扫码App-真·无语出品|com.ninedaystudio.qrcode
简单计算器|com.BlackTeaChan.calculator
满屏都是滑稽|com.EXI.interesting
简酷译|com.Xcn.Translation
阿松-Xperia theme|com.jujueluanma1.xperiatheme
吾记|com.itant.wuji
半身照|com.leqi.banshenphoto
IM@S - Xperia Theme|com.ruokong.theidolmaster
静（简版）|com.jingj.zn
索尼投影|com.ccwonline.sony_dpj_android
插亮屏幕Lite|com.chheese.app.lightthescreenlite
Trackingmore|net.eastboat.trackingmore
小泉花阳 - Xperia Theme|com.tenasama.koizumihanayo
专注目标|com.zhengzhaoxi.focus
爱拍我的世界|com.aipai.android_mcbox
血小板-Xperia主题|com.byjinxmizhou.platelet
Pink Lily-Xperia Theme|com.machao44.pinklily
谋者|com.jzhihui.mouzhe2
MusicBall|cn.heyanle.musicball
通知转发|com.snif.secondphone
联通安全卫士|com.broaddeep.safe.ln
亲宝儿歌|com.iqinbao.android.songs
手机测网速度|com.logan.nettest
CAD坚果云看图|nutstore.android.cad
TT闹钟|com.agg.clock
藏头诗|com.qianniu.poetry
新成工助手|cn.edu.cdtu.school.app
上海银行企业手机银行|cn.com.shanghai.ebank
消息来咯|com.tumuyan.notificationreader
通讯记录查询|com.inntechy.a11039.cdcall
计食器|com.yate.jsq
极简翻译|com.bc.jijianfanyi
名侦探柯南：纯黑的恶梦-Xperia Theme|com.sonymobile.themes.machao014
聪明计算器|com.w.cal
通信卫士|com.broaddeep.safe.lt
简天气|com.jtx.zn
高仿氢-Klwp|hto.tokipukey.kustom.pacl
加密相册|com.dfddsoft.safephoto
瘦思Runtastic Balance|com.runtastic.android.balance.lite
FloatingTips|club.autobug.floatingtips
尼尔：机械纪元 - Xperia 主题|com.andy.nire.automata
ilo|com.huhui.aimian
蜜汁图标包|com.laihz.giconpack.sigma
小书虫|xsc.yue.app
新浪配配|com.sina.peipei
快乐画画板|com.aiduo.fingerpaintfree
放映室|com.lovetv.mglive
高考志|com.cxsj.gkzy
2496|cn.kuwo.hifi
Palette 30 壁纸|com.dsphere.palette30
有道作业宝|com.youdao.coursework
LOL海克斯科技-Xperia主题|com.haikesi.lol
XiaoYu便签|gov.xiaoyu.note
画展宝|com.example.iyishua
个性提示音|com.life.voice
RSCalculator计算器|com.rs.rscalculator
唧歪秀视频桌面|com.jiwaishow.wallpaper
智能温度计:Thermo|com.withings.thermo
一句签名|com.yjqm.zn
静|com.jing.zn
剪贴板管理器|devdnua.clipboard.pro
屏幕隐私滤镜:Privacy screen filter and lock|com.sand5.privacyscreen
喵呜天气|com.hengweather.android
Plants - 雅思备考助手|com.kewojiaoyu.plants
超级隐私管家|com.xd.applocks
IT168文库|com.it168.wenku
财经日历|com.kx.cjrl
天天记账|me.shouheng.dailykeep
REncrypter - 保护您的聊天不受监控|net.rachel030219.rencrypter
极简记账-记账本|com.luyun.simpleaccout
看啥电影|ai.botbrain.kansha
ECOVACSHOME|com.eco.global.app
FileMagic-文件预览/信息查看|com.tumuyan.filemagic
笔头备忘|wang.tyrael.todo
AppInfo|com.fxc.appinfo
17PDFReader|com.buildtoconnect.pdfreader
时刻帮|com.shb.assistant
和苗儿童手表|com.toycloud.watch2.YiDong
QWRed|hb.xm.qqq
Mod·简|cn.modificator.watchfacexishi
北京实时公交地铁|lin.apps.bjbus
动态同步助手|cn.abcdsxg.app.sendsync
东方日历|com.example.liangnet.eastcalander
双龙 英文版|com.jakting.overwatch.en
fcm通知转发|com.RichardLuo.notificationpush
网易卡搭编程|com.netease.geek
诺基亚备忘录|com.evenwell.android.memo
环动|com.dtw.outthedoor
DShare健康饮食|com.dshare.app
记下|com.woodsho.absoluteplan
微头条|com.lerays.weitt
JIDE|as.mke.jscilent
学一刻|com.van.xiyiyi
Myidea|com.myidea.frspble
酷爪机|com.kuzhuaji.free
友情强档|com.yqsoft.winpim
内涵峡谷|com.neihanxiagu.android
SimpleTouchAssis-极简滑稽悬浮窗|com.example.bingzhuolee.simpletouchassis
新浪港股|com.sina.ggt
母星系|com.motherplanet.planet
SuperLive|com.lesports.stadium
Material Styler|com.skcsllp.ac.materialstyler
迈克菲应用顾问:McAfee App Advisor|com.mcafee.advisory
Wakeup|com.yaojinli.www.wakeup
随便看|com.alijava.view
信息安全英语词典|cn.dictcn.android.digitize.shjd_ecxxaqjscd_18203
360智能摄像机企业版|com.qihoo.camera.ee
亲问|com.taobao.xlab.yzk17
单车玩家|com.bike.main
缤纷必应|com.kanmzi.colorfulbing
anWriter|com.ansm.anwriter
地点提醒|com.strom
flyingreed|reed.flyingreed
XPERIA™ Football Theme|com.sonymobile.themes.football
故宫明信片|bowcat.postcard
我的日记|diary.my.life
Article Read|huangtx.article.read
吹响！上低音号-Xperia theme|com.jujueluanmam.xperiatheme
EMUI主题-懒夏|com.lanxia.xiaoying
XOR编码器|com.zhanhong.xor
RWallpaper|com.zncm.rwallpaper
唐诗宋词|com.aiduo.gushi
广西一卡通|com.goldsign.ecard
时间颜值|colortime.livewallpaper.luoyiqi.com.colortime
潜记|com.zyqj
相册刷新|yyc.flush
XPERIA™ Cityscape Rio de Janeiro|com.sonymobile.themes.cityscaperio
直觉|com.baofeng.photoframe
漫画库|com.tianhai.comics.ku
东方天气|com.eastweather
资产管理|com.zhaoyang.assetsmonitor_family
密码相册锁|com.dida.appphoto
有电|com.loopeer.android.apps.chargeshare
Flare-on滤镜|com.markusslugia.iconpack.flareon
云语日记|com.jyy.ediary
诗词中华|com.bruce.poemxxx
最近安装|com.app.recentinstall
蒲公英|im.pgy
珍品网|com.zhenpin.luxurystore
心華-Xperia主題|com.yourcompanyname.theme1118448371
天天快抓|com.bhu.WaWa
骆驼快充|com.ecaray.easycharge
轻云浏览器|com.liapp.qingyunbrowser
汇率换算器|com.brainbinsoft.quickcurrencyconvertermp
划重点|com.ivali.imark
小译|com.baguofanyi
Stardust|org.swsd.stardust
博物官|com.tencent.ar.museum
草莓播放器|me.luwenjie.lazytv
成语词典扬帆版|dls.com.chengyucidian
发票王|com.links.invoice
TOP250|com.aidchow.doubanmovie
拉面原创|com.lamian.android
云脉|com.yunmai.scaleen
密盒|com.Xcn.Secret.box
氢化钾-klwp|kh.tokipukey.kustom.pack
菲林中文|com.jiangxq.filmchina
单词部落|com.knowbox.word.student
易天气|com.mndream.easyweather
状态栏GPS|com.BlackTeaChan.StatusBarGPS
剑网3同人口袋|ibuger.gwwzhenshuai
德汉科技大词典|cn.dictcn.android.digitize.tjdx_dhkjdcd_19003
Neo Notes|kr.neolab.neonotes
联想 REACHit 网盘同步|com.lenovo.reachit
转字符图|yanyan.com.tochar
纸上|com.cdh.paperup
灯塔|com.winwin.wallpager.dt
反病毒程序免费版:Antivirus Free|com.zrgiu.antivirus
猜诗词|com.billy.guesspoetry
报童|com.surine.paperchild
快快旅行|com.kk.trip
单位转换|com.bai.unitconverter
勾股篮球|com.example.gougubasketball
彩虹六号：围攻-Xperia主题|com.aidayuipon.rainbowsixsiege
陌讯云便签 (AR便签)|mosisson.monote.monote
泡泡|com.pcpop
家乐宝生鲜|com.jialebao.view
四级词汇学习|com.zuiniuo.cet4
KING ARTHUR - Xperia主题|com.sonymobile.themes.kingarthur
Icons Exporter 图标库|id.delta.iconsexporter
有道口语|com.youdao.crackingenglish
周大福TMARK|com.goldway.tmark
健身统计|com.billy.exercise
息屏提醒 Always on AMOLED|com.newgen.alwayson
轻光笔记|com.example.krehizi.lightnote
方程计算|com.sanmu.calculator
轻记-告别繁琐只有简单|ttclub.memo
Memo|win.cycoe.memo
AnyCam|com.gooclient.anycam
简单锁屏|com.lili.mylock
墨记|com.denglin.moji
RyFit云悦健康|com.chronocloud.bodyscale
苏宁拼购|com.suning.sugs
Remusic|com.wm.remusic
诺基亚家用摄像头:Nokia Home Cam|com.withings.home
应用锁|com.aiduo.applock
雾霾追踪|cn.crane.application.aqi
最美诗词|com.tech502.poetry
安全期|com.yousheng
C翻译|site.yvo11.ctranslate
Javascript IDE|ramLabs.namespace.javascriptide
微软个人购物助手:Microsoft Personal Shopping Assistant|com.microsoft.psa
Smart Player|com.siliyuan.free.musicplayer
Recent Notification|com.libin.notification
秘迹搜|com.entropage.mijisou
随 心|com.lovetv.lxlive
Mod · 白玉盘|cn.modificator.watchface_moon
TextSharing - 随心记录+分享|net.rachel030219.textsharing
下课倒计时|com.adam.classcountdown
分享文本到剪贴板|com.zhihaofans.share_to_clipboard
正鲸说|com.kezhuo
与声|com.voice.zjy
幼儿拼图|com.jcayyc.carpuzzle
MaterialWeather|org.zackratos.weather
GankDaily|com.gudong.gankio
手工制作|com.mandi.sgxq
tickers|com.markobl.tickerfeed
AccessToHeart|access.to.heart
星空锁屏root版|com.ofans.lockerroot
断片守艺人|com.sohu.kuaizhan.z5496374642
记分牌|com.example.android.counter
鳞集|io.deepink.collection
True Key™ by Intel Security|com.truekey.android
一键锁屏|com.kevin.locksreen
可听|com.hpkj.yzfm
KK探索版|com.qk.search.browser
2018NewYear-Xperia主題|com.yourcompanyname.theme2018newyear
穷~记账|poorbookkeeping.poorbookkeeping
火车时刻表|com.example.trainschedule
曹操讲作文|com.zhaowen.caocao
醒了么|com.yulin.alarmclock
BitKeep|com.bitkeep
你的天气|com.linuxer.yourweather
起亚AR使用指南|com.Tekville.KiaARManual
小窝天气|cool.lr.python.weather
轻松志愿|com.sbd.qszy
色彩控-klwp|color.tokipukey.kustom.pack
诗歌中国|com.appbyme.app159001
早睡飞船|com.sysr.mobile.zsfc
最大音|com.frank.maxsound
神琥录音|com.cinghoo.privacyguard
八哥说话教语专家|com.anforen.radiostory
图标包演示模板 - IconShowcase Demo|jahirfiquitiva.apps.iconshowcase.demo
天真|com.PBK.tzyds
FirefoxLite浏览器|cn.mozilla.rocket
有道数学|com.youdao.youdaomath
锁屏秀|com.kingsoft.lockscreen
时光记|com.rair.diary
迹象sign|com.smysjxqw.chabei
人民体育|com.peoplesports.activity
点滴目标—优雅打卡养成习惯|com.voyager.daily
多多菜谱|com.duoduo.cf.ck
聚盒|com.example.yangxiaolong.privatecustom
汉字演变|Chinese.character.evolution
智能语音闹钟|com.billy.alarm
LoveLive闹钟 园田海未|moe.sonodaumi.clock.umiclock
战吧电竞|com.stnts.coffenet
私密照片保险箱|com.shangkun.safepic
Microsoft Planner|com.microsoft.planner
小林家的龙女仆Miss Kobayashi's Dragon Maid - Xperia主题|com.wuyitheme.misskobayashisdragonmaid
书客编辑器|cc.ibooker.ibookereditor
易贴图|com.ckj.sticker
倾刻|com.svp.video
加密相册管家|com.luyun.secretbox
Magic Locker (魔力应用锁)|mobi.trustlab.lockerlab
宝宝假日旅行|com.sinyee.babybus.holiday
Zr|com.hb.rssai
拍拍壁纸|com.sunanang.sunwallpaper
Anywhereshare|com.mockingjaybirdy.anywhereshare
V2LF|io.github.w4mxl.v2lf
出包王女-To Love Ru-Xperia Theme|com.ztf.toloveru
矩阵初等变换|com.JZCDBH
火车票提醒助手|com.tobetheonlyone.a12306helper
Sharedr|com.rejh.sharedr
无奇动图|com.gif57.android
SprintNBA|com.sprint.nba
快捷大师|com.lmiot.surpertool
简易计算器|com.shekey.calculator
小书生|com.bitworkshop.litebookscholar
果仁|so.udl.guorener
AKu|com.xd.commander.aku
领络|org.linklaws.app.android
Theme REE（KLWP主题）|themesree.kustom.pack
Ai相册|com.xeditor.show
Flying 笔记|com.flyingnotes
布谷请柬|com.yiyue.buguh5
高考倒计时|com.fastkylin.timer2
简 LoveLive！ - Xperia Theme|com.ruokong.lovelive
复制链接到剪贴板:Copy Link to Clipboard|nl.robwu.copylink
薪算|com.txyu.salarycalculator
极客头条|com.gogh.afternoontea
童玩儿|com.tongwaner.tw
姨妈呵护助手|com.mengdie.womencare
浮图酷|com.aber.aberGoodSe
FILMIGO视频剪辑视频编辑工具|com.funcamerastudio.videomaker
火秀运动|com.huoxiuyundong.fireshow
掌上沈理|com.sylu.qinli
京东新鲜GO|com.jd.fridge
小瓶盖|com.unicre.tax.calculator
帝彬音乐引擎|com.dibin.msc
Fiestable|com.sony.songpal.dj
简 ラブライブ! - Xperia Theme|com.ruokong.lovelivej
零食猎人|com.fireapex.snackhub
adidas All Day|com.adidas.allday
M Fit|com.icare.lifeme
哈弗互联|com.navinfo.gw
邮政快照|com.xingfu.emailyzkz
Vizmato|com.globaldelight.vizmato
智位来|com.qidian.seat
记小账|com.weishangjizhang
雷哥单词|thinku.com.word
IT168|com.it168
blcolor|blcolor.kustom.pack
美晨天气|com.android.tu.tuweather
小密|com.example.ish.accountist
iTime|io.github.yisudev.itime
21Days|com.niaozhatian.days21
多方计算器|com.example.kid17.calculator
书乡|com.shuxiang
肥明天气|cn.tonlyshy.app.fmweather
驴妈妈E-Booking|com.android.gift.ebooking
喝了吗|done.staker.com.done
光合未来|com.nature.future
PDF阅读助手|com.scy.readingassistant
头条前瞻|com.forward.qzfun
喵了水滴|cn.ommiao.waterdrop
二胡调音器|com.zxlstudio.erhu
随亿录|com.xklongylp6
密空间离线版|com.hitsme.offline.locker
花豆心愿单|com.moage.huadou
网络小说阅读|com.zhanh.read
分数智能计算器|cn.creater.fei
声控灯|com.dabai
佳音电台|tw.org.goodnews.radio
旅视|com.saygoer.vision
Photo Desk (相册)|com.fletamuto.googleplay.photodesk
游戏葡萄|com.coolgame.youxiputao
斑-Xperia主题|com.nroadthemecreator.ban
拉卡拉收钱吧|com.lakala.shouqianba
每日天气|com.zsx.weather
Vooha|com.in66.vooha
上海实时公交地铁|lin.apps.shhbus
小度之家|com.baidu.duer.smartmate
高级应用锁|com.bingo.applock
易划EazLi|com.qeexo.fingersenselauncher
蜘蛛精|com.spider.reader
SoftBank-Xperia主題|com.yourcompanyname.softbank
艺秒|net.emiao.artedu
科大图书馆|com.xuzhipeng.wustlib
地图-没事看点地图玩玩|com.coolerk.map
FY掌上大学s|cn.czfy.zsdx
ZONE|com.ksballetba.one
NAZG III|com.ttop.nazg_3
大翻译官|com.rdtx.supertranslate
小美人儿|cn.poco.facechat
最常见的英文短语|com.titan.app.vn.englishphrase
Itimer|cn.com.itimer.tim.itimer
App Quick Finder|cn.crane.application.appfinder
UF技统|com.uf.ssp
豆视|com.doushi.bean
WiFi小助手|com.wealwifi
动物之森动态壁纸:Animal Crossing: Pocket Camp|com.nintendo.zaca.w
爱奇艺票务|com.qiyi.android.ticket
密码相册|com.mydidaapp.album
微赢期货|com.qhjy.papaya
曜酱！|com.koch.yov
旋转字幕|com.xuanzhuanzimu.android
随手账|com.wxm.keepaccount
轻风天气|com.qiushiweather.android
Rplayer|com.r.rplayer
心情日记本|com.liuzb.moodiary
将就-Klwp|settle.tokipukey.kustom.pack
一读|com.nkcs.ereader
吃乎外卖|com.xunjoy.lewaimai.user.consumer.chihuwaimai
音乐专辑|com.ttt.yyzj
码字之语|com.MZZY
抓鸟翻译|com.zhuaniao.dict
手持酷炫弹幕|com.lexun99.danmupro
Capsule Jungle|com.yourcompanyname.cj
智慧公交|com.waitbus.m
简 765 - Xperia Theme|com.ruokong.p765
古琴调音器|com.zxlstudio.guqin
掌上故宫|com.sinomaps.forbiddencitywuyuyin1
雅恏|com.yahao.android
MagicaSakuraDemo|com.bilibili.magicasakurademo
橙子便签|com.orange.orangenote
爱动小视频|com.weibo.ido
德语入门|com.izaodao.gm
目錄快照|com.needjava.foldersnapshotfree
物理互动模拟电学|mr.outman
Wandle|com.wandle.app
Hue工具箱|com.superthomaslab.hueessentials
诺基亚智能家居:Nokia SmartHome|com.nokia.dhbu.smartHome
聆译蓝牙|com.sancochip.smarttranslate
艾Pod|com.rair.pod
照片备份隐私相册|com.didipp.appp
AndroidRank|com.hotbitmapgg.studyproject
狂欢桌面|com.tmall.tmallos
KTools|ktools.kustom.pack
Transformers|com.redfrog.transformers
网易萝卜|com.netease.luobo
加密云相册|com.appddphoto.xcsafe
一番街|com.yifanjie.yifanjie
微速聊-微信自动发消息|com.Poison.wxsuliao.app
图片管理器|com.wjkj.hide.picture
老厨子|com.cook.greens.kitchen
CC计算器|com.calculator.cc
美图遥控器|com.meitu.mobile.meituautodyne
Task|com.achjqz.task
相册锁|com.didasafe.photolock
清早闹钟|com.example.liangnet.qingzaoclock
ThinkPad Stack Assistant|com.lenovo.stackable
华宇图书馆|com.huayutong.library
中医执业医师|com.yikaobang.zhongyizhiyeyishi
宝宝学唐诗|com.csj.baby
晴天|com.lhd.weather
女生记账|com.missu.bill
长安书院|cn.cetv.zgjy
胡闹|com.wwdx.alarmclock
小鱼表情|com.yubiaoqing.app
第一读者|com.duzhebao.newfirstreader
易测|com.sh3droplets.android.surveyor
乃木坂46-Xperia主题|com.aidayuipon.nogizaka46
云盘加密照片备份|com.differdida.albumsafe
猫说|com.manssi.maoshuo
韭菜资讯|com.zujikandian.android
WoBlogs|com.mo.woBlogs
相机取色|com.xiangjiquse.android.by.liyi
看小说|com.crazecoder.novel
一条锦鲤|com.moechain.onefish
颜设|co.yanshe.yanshe
CVAI|com.cedricchan.cvai
日记本|com.xyf.notepad
EZPhoto|com.example.ward.ezphoto
旅行计算器|yiteben.com.travelcalculator
到账铃声制作|com.lexun99.ling
记账计算器|com.dida.xmjzjsq
画声|com.yidian.huasheng
Reputation Beta - Xperia Theme|com.justgallery.sonytheme.reputation
阳阳双语早教魔法学院|com.xuexue.lms.academy.android
简 Aqours - Xperia Theme|com.ruokong.aqours
物理电学模拟互动学习|phet.elect.study
BanG Dream-Xperia主题|com.aidayuipon.bangdream
嗶葩神|com.geraldwallace.bpashen
相册加密软件|com.ddfddsafe.jiamima
卜石|com.bushi.bushiapp
中大青年|com.hoge.appBuqI0iGjor
唱鸭|com.rockets.chang
嘻哈菜谱|cp.leiyi.com.caipu
简 μ's - Xperia Theme|com.ruokong.us
AutoSigned 签名便签|com.qingyu.qnote
秘密守护|siliyuan.security
记事提醒册|com.zhizhou.dateremaind
百度拇指医生|com.baidu.doctor.doctoranswer
简浏览器|com.bing.simplebrowser
黑板侠|com.heibanjiaoyu.app
中中单车|com.easy.zhongzhong
照片保险箱|com.softddapps.photobox
Perseus (原 锇·工具箱)|aosp.toolkit.perseus
全国天气空气质量|com.liuzb.weather
MOKA魔咔|com.tencent.moka
Halloween万圣节 - Xperia主题|com.nroad.hallowoon
触宝输入法Fun|com.cootek.smartinputv5.oem
酷天气|snow.coolweather.android
趣喝水|net.liuchuo.idrink
加密相册备份|com.ddsafeda.photoalbum
隐私相册保险箱|com.differapp.yssafe
SharpIDE|net.theluckycoder.scriptcraft
优分享浏览器|com.youkes.browser
宝宝快听|com.childrensong
阿拉伯文翻译|lf.ranslate.zhara
星迹|org.sat.track
发声计算器|com.calculator.au
月读|com.life.s
完美壁纸|com.gzoom.perfectpaper
美饭|com.project.prettymeal
科大汇|com.MyFusApp.kedahui
冰雪奇缘-Xperia主题|com.yourcompanyname.olafadventurebyjinxzhou
耳朵阅读|com.erduoyuedu
文件快传|com.qw.tools.ft
零跑|com.dahua.leapmotor
ABC英语作文|com.nimiuer.niuiere
芝麻商标查询|com.mengdie.trademark
水润|com.example.likang
宝宝涂鸦小能手|com.crazycat.kidsdoodle.paint
晋剧荟萃|science.iscier.jinju
主创|com.bm.maindesign
Graphice|com.franco.graphice
比分记录器|com.mycompany.scorenote
暴风热点|tv.jiayouzhan.android
Youde滤镜|com.youde.leo.youdecamera
竹简|cn.harlan.bambooslip
KillGesture|com.tf.KillGesture
Clinic AA|cn.studyjams.s2.sj0225.zhaojuan.clinicaa
练练西语|com.lianlianxiyu.xiaon.lianlian
KuPOWER-智能移动电源|com.kupower.dock.explorer
秘锁|com.vjson.secretlock
青空文庫|com.clem.aozora
球行天下|cn.winnersclub.qxtx
小猪佩奇绘画着色书|com.bluecat.pepapig.coloring
Ole lifestyle|com.crv.ole
姬丝秀忒·雅赛劳拉莉昂·刃下心Heartunderblade - Xperia主题|com.wuyitheme.heartunderblade
隐私照片保密相册|com.ddappsafe.baomi
名人名言查询|com.mingrenmingyanchaxun.android.liyi
Arukas Docker|com.xbw.arukas
博物馆绘本|com.ecnup.atmgPQ3
故宫心情日记|com.gugongdiary
空白格|com.jiaoming.hgg_riji_app
融艺|net.appwinner.resplashdemo
北京石油|com.pcitc.mssclient
桂工课程表|com.lkm.GlutCT
喵凉|com.miaoweather.android
周记|com.shijie.pojo.zhouji
Event清单|top.dodeman.things
贤读|com.example.liangnet.gushi
懒人点餐|com.zyqzyq.lazyorder
成都晚报|com.bs.encc
托伴托福|com.tb.tech.testbest
剪辑特效大师|com.mvtrail.shortvideoeditor.cn
短说|com.duanshuoapp.mobile
汽车评中评|com.carreview.project
爱迪小状元|com.zmk12.app.zhima_edi
晓天气|com.jojoweather.android
欅坂46-Xperia主题|com.aidayuipon.keyakizaka46
Coffee Lite|com.coffee
技师帮|com.bj.shanbang
InvoluteCalculator|com.ptb.length.involutecalculator
地铁车门计算器|club.evensoft.dalianmetrocalculator
爱奇艺安全盾|com.iqiyi.qis
简 IM@S - Xperia Theme|com.ruokong.imas
北京日报|com.neusoft.app.beijingdaily.phone
小度涂鸦|cn.edu.chd.yitu
短信猎人|me.liwenkun.smshunter
时空音乐|com.iskyy
学问App|com.jinlanmeng.xuewen
列车时间表精简版|org.paoloconte.treni_lite
Welywely|com.xunlei.deepvoice
MD阅读器|com.lyy.mdreader
13克|com.mima
Tirlo-流行女装|com.nineyi.shop.s001532
小鹿记|com.zuiapps.deer
BookKeeping|com.example.chenm.notebook
落尘文学|com.luochen.reader
学霸猜字|com.aiduo.xuebacz
小爱捷径|com.love.shortcut
Wallser|thenextvoyager.wallser
LED跑马灯|cn.ljt.led
阳阳识字大战僵尸|com.xuexue.lms.zhzombie.android
多多看书|sogou.mobile.sreader
锁屏泡泡球|com.gj.plocl
想睡让睡眠成为时尚|com.thinkskey.lunar2
高考志愿专家|com.borsche.gkzyzj
智能移动电源服务|com.kupower.dock.manager
民大课表|com.mawanjun.mindakebiao
飞选酒店预订|com.gogtrip
海底世界主题:Chromatic|com.hola.launcher.theme.zc14930
七彩云备忘录|yjw.john.kzbwl
掌上纺院|com.czfy.zsfy
工艺大师|cn.sparklespace.craftMaster.pottery
枫叶商城|io.chinieer.fyfqg.app
Python编译器|coding.yu.pythoncompiler.new
红周刊|com.hongzhoukan
西邮记|me.lancer.xupt
酷爽天气|com.njp.android.kuweather
冀爱足球|com.example.lovefootball
记录美好一天|com.goodthingshappeneverday
轻果|com.qingguo.app
音基100|com.yinji100.app
ABCmouse|com.tencent.abcmouse
禾少表|oboard.timer
花兮|com.huaxi0.huaxi
天天快报效率版|com.tencent.readingfocus
每天|zxz.rili
BBIN客户端|net.qiujuer.bbinclient
应用锁|com.tesla.lock
明星事|com.app.meanthings
漫天气|com.nico.mantianqi
兰州大学|com.hzsun.smartandroid
氢氧化钙-klwp|caoh.tokipukey.kustom.pack
VPANEL云会议HD|com.maxnerva.smartcity.vboard
Gank|com.three.gankio
一直看|com.yizhikan.app
名片阅读器|com.abbyy.mobile.bcr.lite
国盛通|com.hundsun.stockwinner.gszq
烟云天气|com.momentweather
健美计步器|net.canking.steplog
密友|com.utangic.contacts
电缆编织截距计算|com.liulangpingsai.helloworld
Advancer-探索者（应用管理、壁纸精选、天气微件一体化）|com.leanderli.android.advancer
梦次元表情包|com.pandecheng.mengciyuan.sticker
SC 3rd|com.zhihaofans.server_chan_3rd_party
FES Closet (China)|jp.co.sony.fes
汇智Life|cn.deali.smart_life_lw
个人所得税计算2019|com.dida.taxcalc
西邮Grade|com.example.dickjampink.logintest
Merry Christmas圣诞节主题|com.nroad.merrychristmas
宝宝认数字|com.jcayyc.mathgamesforkids
小农丁|com.so.xiaonongding
合刷|com.daohe.yzh.heshuampos
塞尔达地图|com.qxcm.zeldamap
少女歌剧——Xperia主题|com.vanillaworks.starlight
数胎动|com.yunma.fetaltool
来电闪光助手|com.weallight
秘盾|liuzinan.midun
快开单|com.maoren.fast.bill
竹笛调音器|com.zxlstudio.zhudi
Hola主题-The Little Adventurer|com.hola.launcher.theme.zc14989
SmartkeyForTasker|com.example.smartkeyfortasker
简笔涂色|com.UnicoGameStudio.CCBook
宝宝音乐派对|com.sinyee.babybus.musicparty
哈哈天气|com.hahaweather.android
日日记|com.meizou.xioaji
蔚然天气|org.kylin.weiranweather
开心狼人杀|com.lv3.kaixinkill
TFLite Object Detection|org.tensorflow.lite.examples.detection
T翻译|com.tian.tan
FirstJob|com.jngz.service.fristjob
7频道|com.hoge.android.app.qpd
悠百佳|com.ybj.food
小牛接招|com.channelsoft.hyb.studentapp
打开URL|com.yaxisvip.openurl
唯思活检|smart.visi.com.facedemo
限制儿童使用手机|com.anforenpass.LockTimer
北京天气预报|com.songheng.beijingtianqikuaibao
路德FC|com.road
速易查|com.y9wenping.mywords
摄影图库|com.freecats.splash.splash
走遍美国·USA|sr.daiv.bits.usa
快三翻译|kuai.san.translate
感观世界|com.sensoryworld
壁纸包演示模板 - WallpaperBoard Demo|com.dm.wallpaper.board.demo
基础意大利语口语|sr.daiv.alls.it
BBC双语英语听力|com.tataera.bbctingli
海客视频|ai.botbrain.haike
友音阅谱|com.suishenyun.youyin
RunPeeChina|air.com.runpee.rpc
百分记账|com.niaozhatian.jizhang100fun
七巧板梦象动态壁纸|com.idddx.lwp.tangram
热点综艺|com.ttt.rdzy
Hola主题-Bubbly Forest|com.hola.launcher.theme.hl391
英语翻译助手|com.englishfygtoom
逢田梨香子-Xperia主题|com.aidayuipon.rikako
麦咭萌|com.jykt.magic
牛眼国际版|com.bullseye.app
次元笔记|com.dimension.note
鲤溪作业统计|com.gardilily.homework_2
灵犀天气|com.smice.wiseweather
手机数据恢复|com.bgy.wxrecovery
Loophoto-本地壁纸切换|com.icecherry.wallpaperCycle
琵琶调音器|com.zxlstudio.pipa
和火掌柜|com.yst.shopkeeper
iNotes|io.github.yisudev.inotes
Who's In|com.microsoft.bing.whosin
物流先锋|com.pioneer.logistics.inquire.app
扬琴调音器|com.zxlstudio.yangqin
芝麻关门|com.example.myapplication.gpxmap
FamilyTree|lau.stephen.familytree
便便出行|com.convenient
飞远消防|io.dcloud.H528D9860
中国纺机集团|com.example.fuz
时事体育|com.ttt.ssty
成医教务|me.lancer.cmc
发电助手|com.yunhwa.fadianzhushou
GoodNight|com.goodnight.everyone
态度推客|com.taiduzhifu.tk.android
最美壁纸|com.lqh.beauty.wallpaper
中国发电机供应网|com.sffdj
偶像大师百万现场-Xperia主题|com.theidolmastermillionlive.chifu
Chaozhisoft|com.android.Chaozhisoft
扫码|com.lyn.myscan
童画精灵|com.app.draw
上个应用|project.radua.lastwork
魔术相机|com.pihee.mc
iword|com.example.iword
问道国学|com.bigdata.disck
简约天气|com.example.asustp.coolweather
景泰蓝|cn.sparklespace.craftMaster.cloisonne
易司法群众端|com.sifa100.judicialmass
语音文档|com.yidian.vsj.huasheng
Python console|cool.lr.python.console
微视财经|com.yunzhang.weishicaijing
书香上海|com.imread.shanghai
汉元素|cn.apppark.ckj10812813
二年级语文|org.cocos2dx.caiChineseWen2
综合测评计算器|com.nesp.comprehensive.calculator
熊猫巴士驾驶员|com.play.busxmas
一个便签|com.su.notepro
巴适公交|com.ixiaoma.custombusorigin
飞电时钟|com.tghcxbf.gvtvbo
自然睡眠|com.charles.shuiminyinyue
听信|com.projectx.notificationreader
锤锤文件扫描|com.hammer.scan
四年级语文下生字表|org.cocos2dx.learnChene2218
追番表|com.lxfly2000.animeschedule
奇点汽车|com.singulato.scapp
图文长图|com.xiaoqiang.storypicture
荣耀手机数据连接默认卡设置失效修复工具|cn.qssq666.fixengine
小浪扣字机|com.yu.kzj
初中英语听力|com.csliyu.listenjunior
病历管家|com.dida.mcloud
悠悦俄语论坛|com.euyyue.bbs.phone
北京农商银行|cn.com.bjns.mbank
表情Maker|com.jianyuyouhun.facemaker
磁能手电筒|com.orangeboston.magnetic
iWUST|shawn.xiafei.iwust
球保号|com.lvche.qiubaohao
班比|com.immsg.banbi
通知栏消息记录|com.hammer.accessibility
乐竞体育|com.bstk.lesport
爆版进销存|com.fumikeji.dangkou
酷酷单车|com.bike.ttdc
TFL Classify|org.tensorflow.lite.examples.classification
邦客惠|kl.enjoy.com.klapp
赛普健身|saipujianshen.com
趣赞Point|com.point.quzan
AirTranslator|com.newairtranslator
回拍|com.fantasy.app.client
MLua|com.mlua
随便设置一张壁纸|com.example.xf.randomwallpaper
掌上大众-查课表|com.example.administrator.checklist
车答答|com.xi6666.cdd
OCR图文识别|com.geeeeeeeek.office
心墙|cn.jcxinqiang.www
全民共进|com.shuyun.qapp
深圳通|com.szt.pay
宿院助手|mepride.android.coursehelper
看视频|com.android.video.thlplayer
问安|com.vean.cimp
中日翻译|com.hhll.translatecnja
博客园|com.zhaoyang.cnblogs
喵了锁屏|cn.ommiao.lock
午时已到|cn.wthee.highnoon
手机清理大师|com.yibatec.yourmasterclean
蓝莓记账|com.ldh.blueberry
乌鲁木齐地铁APP|com.goldsign.urumqimetro
小飞在线|com.iflytek.home.app
汉字笔顺|com.kuyun.demo
开开专车|cn.faw.yqcx.kkyc.k2.passenger
九福商城|net.dm9f.aseanmall
慕书读书|com.dianshi.mobook
八一追书|com.example.uforeader.skreader
排班日历|com.julanling.workschedule
书岛|cn.wz818.bookisland
ZebraGo|com.zebratech.zebrago
爱记事|com.kylec.ainote
LeetCode算法题库|com.geeeeeeeek.study
徐州图书馆|com.xuzhou.library.eva
Lyiconpack|com.by_syk.iconpack.yl
失物树|com.itant.shiwushu
追剧指南|com.zs.tv.app
随机抽查清音表|local.shamrock.randomize
Weather|com.mryu.weather
千千标签浏览器|cn.com.wiisoft.qianqian
中韩翻译|com.hhll.translatecnko
石中剑|moe.yonjigen.caliburn
威海公交官方|com.ibuscloud.weihaibus
轻记|io.github.hellobird.simpledo
广州限行通|com.g704833366.dzf
简翻译|com.brins.translation
禁用自动亮度|com.sdjzu.wangfuying.disableautobrightness
定时关机X|com.fang.timeoutx
记住打卡!|com.lw.offwifi
银米天气|com.pc.yinmi.inmosweather
大声闹钟|me.jlabs.loudalarmclock
分币|com.fenbi.jack.production.v
Live视频桌面|com.yangh.livewallpaper
余额记账|com.kbl.balancebook
高考倒计时锁屏|com.chunyuqiufeng.gaozhongapp.screenlocker
最优汇率|project.com.exchangetools
脑洞|org.codeinterpreter
小黑笔记|com.tmgp.conan.taichi.jishiben
光影|com.hansion.funnytime
密码记事本|com.jxx.pwdnote
美颜效果相机|com.zs.q.picart
clippingkk|com.annatarhe.clippingkk
咖啡笔记|vip.coffee.cod
SAF 增强器 Lite|app.gwo.safenhancer.lite
手机公众通|com.gzt.busimobile
时间去哪了|zql.warriors_timess
星环打卡|com.fm618.dev.starringcheckon
凤凰信用卡|cn.com.bjbank.mbank
通讯录|com.android.contacts
浏览器|com.android.browser
日历|com.android.calendar
计算器|com.android.calculator2
信息|com.android.mms
电话|com.android.dialer
设置|com.android.settings
时钟|com.android.deskclock
图库|com.android.gallery3d
音乐|com.android.music
XXX|com.x.server
谷歌浏览器|com.android.chrome